ank	अंक
anka	आंका
ankit	अंकिट
anakon	अनकों
ankhon	आंखों
ankon	एंकों
angkor	अंगकोर
ankor	एंकोर
angaarak	अंगररक
angarak	अंगरकक
angraji	अंग्रजी
angreji	अंग्रेजी
angrzi	अंग्रजी
antah	अंताह
antaha	अंताहा
antarmukh	अंतरमुख
antmurkh	अंतरमुक्
antrmukh	अंतर्ुुख
andrabee	अंदररबी
andrabi	अंदररबी
andha	अंधा
andhapan	अंधापन
andheri	अंधेरी
ambaani	अंबानी
ambani	अंबानी
akram	अक्रम
acapulco	अकापलकॉक
akapulko	अकपुलकों
akhand	आखंड
akhil	अखिल्ल
agavai	अग्वई
agvaai	अग्वाई
augustine	अगस्टटनन
augustustine	अगस््ट्सेनन
agsta	अग्सता
agusta	अगसत्ा
augusta	अगुस्त
agr	आग्र
agra	आग्र
achambha	अचंभा
achanbha	अचंभा
achievement	अचिवममेंट
achivement	अचिवेमेंट
acchi	अच्चि
achchi	अच्छी
achhi	अची
achyut	अछ्युत
achhanera	अचलेरा
achnera	अचनेरा
ajmeedh	अज्मिध
ajhar	आजरर
azhar	अज़र
ajit	अजीत
agnat	अग्नात
agyaat	अज्ञात
agyat	अज्ञात
atakta	आत्कता
atkata	अतकता
atake	आतकक
atke	आटके
atwaal	अत्वल
atwal	अत्वल
attahasa	अत्तासा
atthaas	अत्थास
atthas	अत्थास
addon	आड्ों
athak	अथक
atharv	अथर्व
atharva	अथर्व
adad	आदद
adaani	अदानी
adani	आदनी
advait	दववैत
adwait	द्वैट
advaitvaad	अव्वत्वाद
advaitwad	अववैतवाद
adhivas	अधिवास
adhiwas	अधिवास
advivas	आद्विवास
adhiik	आधिक
adhik	अधिक
adhyayanarat	अध्ययनारत
adhyayanrat	अध्ययनारत
adhyaynrat	अध्ययन्रत
anant	अननत
ananti	अननती
angadh	अंगाध
angarh	अंगरह
anchahe	अंचहे
anthak	अंठक
unthak	उंथक
anhoni	अन्होनी
anaavashyak	अनावश्यक
anavashyak	अनावश्यक
anavshyak	अनश्ययक
anawashyak	अनावश्यक
anik	अनिक
anishwarvadi	अनुश्वर्वादी
anishwarwadi	अनिश्वर्वादी
anukoltha	अनुकोल्ा
anukulata	अनुकूलता
anukulta	अनुकुलता
anuchit	अनुचित
anuprayogi	अनुप्ययोगी
anuprayogon	अनुप्रयोगों
anupryogon	अनुप्रयगगं
anureet	अनुरीत
anurit	अनूरित
anuthi	अनूठि
anudit	अनुदित
anyaay	अन्यय
anyay	अन्यय
anyaya	अन्यय
apnani	अपनानी
aparivartanshali	अपरिवर्तनशाली
aparivartansheel	अपरिवर्तनशील
aparivartanshil	अपरिवर्तनशील
apariharya	अपरिहार्य
aprihary	अपरिहररय
apriyary	अप्रिययो
apavartit	अपवर्तित
apvartit	अपवर्तित
apvtrit	अपप्रतित
apaardarshi	अपररदर्
apardarshi	अपररदर्
afroj	अफ्रोज
afroz	अफ्रोज
africa	अफ्रिका
abbaasi	अब्बासी
abbasi	अब्बसी
abhimat	अभिमत
abhishap	अभिष्प
abhi	अभी
amjhera	अमझेरा
amzera	अमजेरा
amargad	अमरगगड़
amargarh	अमरगगढ़
amarpaal	अमरपाल
amarpal	आमर्पल
amarohi	अमरोही
amrohi	अमरोही
amaanat	अमानत
amanat	अमानत
amanth	अमांत
amaanati	अमानती
amanathi	अमानथी
amanati	अमननती
amavasya	अमावस्य
amavsya	अम्वस्य
amit	अमिट
amitao	अमिटाओं
amitav	अमिताव
amuk	अमुक
amogh	अमोध
ambani	अंबानी
ayodhyaanaath	आयोध्यनाथ
ayodhyanaath	आयोध्यनाथ
ayodhyanath	आयोध्यनत
ayodhyeanath	अयोध्यनेथ
aradas	आरदास
ardaas	अरदास
ardas	अरदास
arabab	अरबब
arbab	अरबब
around	आरउंड
arjent	अर्जेंट
urgent	अर्जेंट
arth	आर्थ
artha	आर्थ
earth	इर्ट
earthquake	इर्थेकक
arthon	आर्थों
arpit	आर्पित
aryama	आर्यमा
aryma	आर्यमा
arymaa	आर्यमा
alankaar	अलंकार
alankar	अलंकर
alnkaar	अलंकार
alankaaron	अलंकारों
alankaron	अलंकारों
alnkaaron	अलंकारों
alnkaron	अलंकारों
alagavavadi	अलगावादा
algavvadi	अल्गवावदी
algavwaadi	अल्गवावादी
alive	एलीवे
alance	आलेंस
alayans	अलायंस
aliance	एलायंस
alind	एलिंड
alai	अलाई
ali	एली
alii	एली
alonso	आलोंसो
aloso	आलोसो
alphabet	अल्पाबेट
alba	अल्ब
avantipur	आवंतिपुर
awantipora	अवांतीपोर
avaru	अवरु
avru	अवरु
awaru	अवरू
avarodhak	अवरोधक
avrodhak	अवरोधक
avrodhk	अवरोधक
avarnata	अवर्णता
avarnataa	अवर्णता
avranta	अवरंता
avashist	अशशिष्ट
avshisht	अवशिष्ट
awashist	आवशिष्त
avasthaayen	अवस्थाएं
avsthaen	अवस्थाएं
avsthayen	अवस्थाएं
awasthaen	अवस्थाएं
avi	अवी
avika	अविका
aviral	एवीरल
avirl	एवर्ल
avishvaasniy	अविश्वासनीय
avishvasniy	अविश्वंसीय
avishvasniya	अविश्वंसयय
avisvasniya	अविश्वस्यीय
aviva	अविवा
avaigyanic	अवैज्ञानिक
avaigyanik	अवैज्ञानिक
avegyanik	अवैज्ञानिक
ashaktataa	आशकताता
ashktta	आश्कता
asharaphi	आशारपी
ashrafi	अश्रफी
ashariri	आशारीय
ashriri	आश्रीरि
ashrvatath	अश्वर्था
ashvtth	अश्वत्थ
asamaany	असामान्य
asamany	असानायय
asmanye	अस्मान
asaamnjsy	असंंजस्य
asamanjasy	असमंजन्य
asamanjasya	असमंजज्य
asurakshit	असुरक्षित
asurkshit	असुरक्षित
aset	एसेट
asset	ससेट
asvabhavik	अस्वाभाविक
aswabhavik	अस्वाभाविक
aswbhavik	अस्वाभाविक
ahirauli	अहिरौली
item	इटीम
items	इटेमम्स
idle	आइडल
idol	आइडोल
icc	आईसी
iso	आईसो
ipc	िपीसी
ipad	िपद
iris	आइरिस
ounce	आंसस
aakaash	आकाक
aakash	आकाष
aake	आकी
aakhet	आखेत
akhet	अखेत
aagat	आगत
aagaman	आग्मान
aagman	आग्मन
aagaa	आगा
aagah	आग्ह
agha	आघा
aagaashe	आगाशे
aagashe	आगाशे
agashe	अग्शे
aajmaanaa	आजमाना
aajmana	आजमान
aazmaanaa	आजमाना
aata	आता
ata	अता
atta	अत्ता
aatmayen	आत्माएं
atmaen	आत्में
aadaan	आदन
aadan	आदन
aadhaarit	आधारित
aadharit	आधारित
adharit	अधारित
aadheen	आधीन
aadhin	आधिन
aadhunik	आधुनिक
aanad	आनद
aanand	आनंद
anand	आनंद
aapka	आपका
aapkaa	आपका
aapadaaaen	आपदाएं
aapdaein	आपदाएं
aapdayein	आपदाएं
aabantit	आबंतित
abantit	आबंतित
aabru	आल्रु
abaru	आबरू
aamdan	आमदन
amadan	आमाान
aamdani	आमदनी
amadani	आमाननी
aamdi	आमदी
amdi	आंदी
aamod	आमुद
amod	आमोद
aayenge	आयेंग
aayojak	आयोजक
ro	झझओओं
rp	आरपी
aaraam	आरम
aaram	आरम
aram	आरम
aarushi	आरुशी
arushi	आरृष
artery	आर्टर
order	आर्डर
aary	आर्य
aarya	आर्य
arya	आर्य
aaryika	आर्यिक
aryika	आर्यिक
aarya	आर्य
arya	आर्य
aryo	आर्यो
aaryan	आर्यन
arya	आर्य
aryon	आर्यों
aalsi	आलसी
alasi	आलसी
aalochak	आलोचक
alochak	आलोचक
aalochakon	आलोचकों
alochakon	आलोचकों
aalha	आल्हा
aalhaa	आल्हा
alha	अल्हा
allah	अल्लाह
aawaazen	आवाजें
aawajen	आवाजें
awaazen	आवाजें
awazen	आवाजें
aawajon	आवाजों
aawazon	आवाजों
awaazon	आवाजों
awazon	आवाजों
aavishakaar	आविषाकार
aavishkaar	आविष्कार
avishkar	अविष्कार
aavriti	आवरति
aavritti	आवृत्ति
avuti	आवूति
aavritiyon	आवृतियों
aavrittiyon	आवृत्टियों
avrutiyon	आवृत्तियों
aashanka	आशंका
ashanka	आशंका
aashriton	आश्रितों
ashriton	आश्रितों
aasaan	आसना
aasan	आसन
asan	आसन
aastik	आस्तिक
astik	आस्तिक
aasteen	आस्तिन
aastin	आस्तिन
astin	एस्टिन
aahnaan	आहनाा
aahnan	आह्न
ahyan	आह्यन
england	इंग्लैंड
engineer	इंजीनियर
introduction	इंट्रोककशन
insurance	इनसरंंसस
ear	ईरा
eyer	आईर
eon	ईयों
iaan	आईन
ekattha	इकट्ठा
ikattha	इकट्ठा
ekatthi	इकट्ठी
ekthi	इक्टी
ikatthi	इकट्ठी
ekaee	ईकाई
ikai	ईकाई
ekaeyon	ईकाइयों
ikaiyon	ईकाइयों
ikarion	इकारियों
economic	इकोनॉमिक
ecuador	इक्यूडार
equador	एक्वाउडर
equities	इक्विटेज
ikvitija	इक्विगीगा
ijaajat	इजाजजत
ijajat	इज़ाजत
inhalation	इन्हाेनशन
inhaletion	इन्हेंटीनन
ibija	इबीजा
ibiza	इबीजज
imaging	इमैगिंग
immune	इम्यून
elaichi	एलाची
ilaichi	इलाइची
ilayachi	इलायची
ilayichi	इलायिची
elaaj	इलाज
ilaaj	इलाज़
ilaj	इलाज़
ishaak	इशाक
ishaaq	इशाक
ishak	इश्क
ishaara	इशारा
ishaaraa	इशारा
ishara	इशारा
ishita	इश्टिता
isht	इष्ट
isteefe	इस्तीफे
istife	इस्टीफल
ea	ई
ia	ईई
eater	ईटेर
iter	इटरर
email	इमेल
emailon	इमिलों
emelon	एमिलों
evening	इवीनगं
east	ईस्ट
ishat	इशाट
isht	इष्ट
isaaiyon	ईसाईयों
isaiyon	ईसाईयों
isayiyon	ईसाईयों
ikhrul	इख्रुल
ukhrool	उख्रूल
ukhrul	उख्रुल
uchhalane	उछलनन
uchhalne	उछलने
ujback	उजज्कक
uzbek	उज़्बे
uthane	उठाने
uthne	उठने
uthaakar	उठाकर
uthakar	उठककर
uthaapatak	उठापतक
uthapatak	उठपटटक
uthen	उठें
udaan	उडानन
udan	उड्न
udaanaa	उड़ना
udana	उड़ना
udaane	उड़ने
udane	उड़ने
udaanen	उडानें
udanen	उड़नें
udaanon	उडानों
udanon	उड़नों
utane	उताने
utaney	उतने
utne	उतने
uttara	उत्तरा
uttra	उत्र
utpan	उट्पन
udant	उडंडट
udghosh	उद्घोष
udar	उदार
uda	उद्
udaa	उड़ा
udakishuganj	उद्किशागंज
udakishunganj	उद्किशंगंज
unatees	उनतततस
untees	उंटीप
uniyal	यूनियल
upadraviyon	उपद्रवियों
updravion	उपद्रवीन
updraviyon	उपद्रवियों
upadravi	उपद्रवी
updravi	उपद्रवी
upadrawon	उपद्रवों
updravon	उपद्रवों
upneta	उपनेटा
upabhokta	उपभोक्त
upbhokta	उपभोक्त
uplaksh	उपलाक्ष
uplakshay	उपललक्षय
uplakshya	उपललक्ष्य
uplabdh	उपलब्ध
uplabdhiyon	उपलब्धियों
uplabdhi	उपलब्ध
upakhyaanon	उपख्यानों
upakhyanon	उपख्यानों
ubuntu	उबंतु
ubaal	उबाल
ubal	उबल
ubhaara	उभारा
ubhara	उभरा
umanath	उमनााथ
umesh	उमेश
urf	उरर
urfa	उरफा
urff	आरफ्फ
urvarakon	उररवाकों
urvarkon	उरवररकों
urwarakon	उरवारकों
urvarata	उररवरतत
urvarta	उररवरतत
urwarta	उरवररता
ulate	उलाते
ulte	उल्ट
ulahana	उलहान
ulahna	उलहना
ulema	उलेमा
ulemaon	उल्मेमाओं
usak	उसक
usaki	उसकी
uski	उस्की
usmein	उस्में
usmen	उस्में
usi	उसी
ustara	उस्तरार
udharv	उध्रव
udhrva	उद्रव
urdhav	उर्धवा
ushma	उष्म
rishicool	ऋषिकुल
rishikul	ऋषिकुलि
rushikul	ऋषिकुलल
enzyme	इंजीयम
anton	एंटन
entone	इंटोन
antoni	एंटोनी
antony	एंटोी
endometrial	इंडोमेट्रियल
andreas	एंड्रियस
als	आल्स
asi	आसी
eksaath	एकसात
eksath	एकस्ट
ekaki	एकाकी
xm	क्सम
egmor	एग्मो
egmore	इग्मोर
aj	आज
agende	एजेंडे
adp	एडपप
adain	आडिन
aden	आडने
edan	ईडन
addi	अदिी
eddi	इडी
eddie	इडी
eddy	इडि
apj	अपज
ftii	फ्टी
abbott	अबाट्ट
abut	आबुत
ebt	इब्ट
abvp	अल्वप
abbot	अब्ोट
abbott	अबाट्ट
mta	मटा
mtake	मटकके
mtec	म्टीक
mtech	म्टेक
emerald	एमररल्ड
emrald	मर्रल्ड
emil	इमिल
emile	इमिले
emily	एमिली
amy	अम्य
emi	इमी
airway	एयरवेय
eyarave	एयरवे
eyarve	एयरवे
error	एरर
arica	आरिका
erica	एरिका
erika	एरिका
aerobic	एरोबॉकक
aerobics	एरोबाक्स
lte	ल्टे
lti	ल्टी
allergic	एलर्जिक
eliminator	एलिमिनेटर
aliens	एलायंस
alliance	एलायंस
asian	एशियाई
sfc	ससफी
sk	स्क
spf	स्प
association	एसोसिएशन
astar	अस्तर
aster	एस्टरर
ester	एस्टर
aesthetics	एस्टेटिक्स
asthetic	एस्थेटिक
asfalt	अस्फल्ट
asphalt	अस्पलल्ट
asphault	अस्पॉल्ट
ahsaas	अहसास
ehsaas	एहसास
ehsas	एहससस
aisa	एसा
eesa	ईसा
ainth	ऐंठ
end	इंड
enth	इंठ
ainthey	ऐंठे
enthe	ऐंठे
aithan	ऐंठन
ethan	इंठन
ethhan	ऐंठन
ail	एं
el	इल
alaps	आल्प्स
alps	आल्प्स
aise	ऐसे
oxide	ऑक्सीड
oxy	ऑक्सी
offers	ऑफर्स
offshor	ऑफफोर
offshore	ऑफफोरर
official	ऑफिस्यल
okalahoma	ऑकोलममम
oklahoma	ऑकललौमा
oklahoma	ऑकललौमा
ot	ओट
opel	ओपेल
obrayan	ओब्रेयन
obrien	ओब्रियन
oran	ओरन
orian	ओरियन
orion	ओरियो
olavrishti	ओलविृष्टि
ovum	अवुम
owem	ओवम
oceanic	ओसेनिक
osaka	ओसका
auchity	औचित्य
auchitya	औचित्य
audhyogikaran	औध्योग्ककरण
audyogikarana	औदोगिककरण
audyogikikaran	औदोगिककककरण
aurangabad	औरंगाबाड़
aurora	ऑरोरा
aulakh	औलख
kankad	कंकाड़
kankar	कांकर
kankad	कंकाड़
kankar	कांकर
kangan	कांगन
conjunction	कंजंक्शन
contemporary	कंट्पोरोर
kanthahar	कंठाहार
kanthhar	कंठरर
composer	कंपोोर
kambalon	कंबलों
kanblon	कांबलों
consultant	कंसल्टटंट
kakkad	कक्कदा
kakkar	कक्कर
kacche	कच्छे
kachche	कच्चे
karta	कर्ता
katra	कतरा
cutlery	कटलरी
katlari	कटलारी
katlary	कट्लररी
katasaraj	कतारसाज
kathfodave	कथफोद्वे
kathfodve	कथलोद्व
kathor	कटोर
kathore	कटोरो
kanika	कनीक
kathai	कथाई
katthai	कट्थाई
katthaii	कट्थाई
convention	कन्वेशन
canals	कैनलस्स
kanaal	कनाल
kanal	कन्ला
kanindham	कानिंधम
kaningham	कनिंघम
kanishthika	कानिष्ठिक
kanishthikaa	कानिष्ठिक
kanishtika	कानिष्टिक
kanyaayen	कन्याएं
kanyaein	कन्याएं
kanyayen	कन्याएं
convention	कन्वेशन
convocation	कन्वोशेशन
cup	कप
kap	कप
kapda	कपपड़ा
kpada	कपाड़ा
kapdo	कपपो
kapdon	कपडोों
kaping	कपींग
kping	कपपंग
kapolkalpana	कपलोकपानन
kabaddi	कबाददी
kabr	कबरर
kabra	कबरा
kabren	कबररेन
kabron	कबररं
kamjor	कमजोर
kamzor	कमजोर
kamatar	कमाटर
kamtar	कामटार
kalamjeet	कलजजीि
kamaljeet	कमलजीत
kamaauu	कमाऊ
kamau	कमाऊ
kamaate	कमाते
kamate	कमाते
kamere	कमेरे
kmere	कमेरे
karanj	करणज
kranj	क्रंज
karanjiya	करणजीय
kardhe	कर्धे
karghe	कार्घ
karachana	कराचना
karchhana	कर्चना
karna	कररण
karpatri	कर्पतारी
karam	कर्म
karoor	करूर
karur	करूर
karnataka	कर्णटाका
karvi	कारवी
kurvi	कुरवी
kalmein	काल्में
kalmen	कालमें
kalraj	कलराज
kalika	कालिका
kalpanaon	कल्पनाओं
kalpnaon	कल्पनाओं
kavvaliyon	कंवालियों
qawwaliyon	क़ववलियों
kavvali	कवववली
qawwali	क़व्वलल
kashton	काष्टों
kasarat	कसरात
kasrat	कसरता
kasara	कसरा
kasida	कसीदा
kahane	कहाे
kahne	कहने
kahlaya	कहलाया
kahaniyon	कहानियों
kile	किले
kanji	कंजी
cant	केंट
kant	कंंट
kanti	कांटी
kakoo	काकू
kaku	ककु
kaagaj	कागज
kaagaz	कागज
kagaj	कागज
kagaz	कागज
kaaji	काजी
kaji	काजी
kazi	काजी
qazi	काजी
kajoo	काजू
kaju	काजु
kapadi	कपाड़ी
kapdi	कपपीी
kamraj	कामराज
kamottejana	कमोटेटनानन
kamottejna	कमोटेट्ानन
kailana	कैलाान
kaylana	काललान
carfi	कारफी
karki	कर्की
kartik	कार्टिक
karyakartaon	कार्यकारताओं
karykartaaon	कार्यकारताओं
karykartaon	कार्यकारताओं
karyabhar	कार्यभर
karybhar	कार्यभार
karyarat	कार्यात
karyrat	कार्यात
kaalpi	कालपी
kalapi	कललपप
kalpi	कल्पि
kalika	कालिका
kalighat	कालीघाट
coldvel	कल््वेल
kaldvel	कल्डवेल
kaldwell	कल्डवेल
kaav	कवव
kav	कवव
kaasht	काश्ट
kasht	काष्ट
kasim	कसीम
qasim	कसीम
kasimabad	कासिमाबाद
kiya	किय
kiliyan	किलियन
killat	किल्लेट
killi	किल्ली
kisaani	किसानी
kisani	किसनी
kisanon	किसनों
keede	कीदे
kide	किदे
keynote	कीयनटट
kinote	किनोटे
kiratpur	किरतपूर
kundal	कुंदल
kundaliya	कुंडलिया
kundaliyan	कुंडलियां
kutta	कुट्ता
kuposhit	कुपोशित
kumau	कुमाओ
kumavat	कुमावत
kumawat	कुमावत
kural	कुरल
kurmi	कुर्म
kursiyon	कुर्सियों
kush	कुश
kushaan	कुशान
kushan	कुशन
kusumalataa	कुसुमलता
kusumalta	कुसुमलता
kusumlata	कुसुललाता
koot	कूट
kut	कुत
kritika	कृतिकता
kpo	कपो
canterbari	कंं्रबरी
canterbury	केंटरबूर
candidate	कैंडीडेट
katrina	कतरीना
caitlyn	कैटलिइन
cateline	कैटललइन
catlin	कैटलिन
cadmium	कैदमिम
catholic	कैथलिक
catholicon	कैथलिकल
kaetholikon	कैथोलिकों
capacitor	कैपेशिटर
carat	कारटट
cavity	क्विटी
cavalry	केवलरी
kaivelari	कैवेलररी
complex	कंप्लेक्स
kocchi	कोची
kochi	कोची
corridor	कॉरिडोर
corolla	कोरोला
korola	कोरोला
caolan	कॉलन
colan	कोलन
colon	करलों
calling	कॉलिंग
koling	कोलिंग
colorado	कोलरडड़ो
kolorado	कोलोराडो
kaushal	कौशल
kaushalata	कौशलता
kaushalta	कौशलता
kaushambi	कौशंबी
cute	कूट
quete	क्वीट
cube	क्बू
cubeck	कबेक
quebec	क्वेब्क
cubes	कुबेस
krantiyon	क्रांतियों
cric	क्रिक
crick	क्रिक
cricket	क्रिकेट
cricketer	क्रिकेटरट
cricketing	क्रिकिटेंग
kriyayog	क्रियययोग
christian	क्रिस्चियन
kruger	क्रुगर
craig	क्रेज
creg	क्रेग
cradle	क्रैडल
chrom	क्रोम
chrome	क्रोम
client	क्लाइंट
clock	क्लॉक
clasen	क्लेसन
classen	क्लेसन
classon	क्लासों
clay	क्ले
claris	क्लारिस
cleris	क्लररिस
clerys	क्लररिस
quantico	क्वांटिकों
queens	क्वींस
kshitij	क्षितीज
shitij	शीतीय
kshin	क्षिण
shin	शिरन
kshetron	क्षेत्रों
shetron	क्षेत्रों
khand	खंड
khanda	खंडा
khachakhach	खाचखाा
khajarana	खजराना
khajraana	खजराना
khajrana	खजराना
khatakati	खटकटा
khatakti	खटकटी
kihatkati	किहातका
khattapan	खट्टापन
khat	खतत
khani	खनी
khanik	खनीक
khanikarm	खनीकर्म
khanikarma	खनीकरमम
khanikarmi	खनीकर्मी
khapat	खपाट
khariya	खरिया
khalnayak	खलनायक
khaaskar	खासकर
khaskar	खासकर
khaastaur	खास्तरर
khastaur	खासतौर
khaibar	खैबर
khyber	खाइबर
khaein	खाएं
khaen	खाएं
khayen	खाएं
khaate	खाते
khaatey	खाते
khate	खाते
khal	खल्
khinchakar	खिंचाकार
khinchkar	खिंचकार
khilana	खिलना
khinchkar	खिंचकार
khuda	खुदा
khudai	खुदाई
khurapka	खुरपपक
khurpaka	खुरपाका
khurasan	खुरससन
khushiyan	खुशियां
khene	खेने
khaini	खौनी
khairati	खैरती
khoikhoi	खोईखोई
khoya	खोया
gangrel	गंग्रेल
gangaajal	गंगाजल
gangajal	गंगगजा
gandaki	गंदाी
gandki	गंदकी
gandh	गंध
gandha	गंधाा
gae	गाई
gaye	गाय
gajara	गजरर
gajra	गजरर
gadkar	गड़कर
ganapati	गणपती
ganpati	गनपती
gatisheel	गतीशील
gatishil	गतिशील
gatishilata	गतीशीलता
gadadhar	गदाधार
gammat	गम्मत
gaya	गाय
garibi	गरीबी
garjana	गर्जना
galgand	गैलगंड
gahmagahmi	गहमगागी
gemhagehmi	गेमहाग्म
ganguly	गंगुल्य
gaanth	गांथ
ganth	गंठ
gaanthe	गांठे
ganthe	गंते
ganthen	गंतहें
ganthon	गंठों
gaen	गाएं
gayen	गाये
gazi	गाज़
gajipur	गाजीपुर
gazipur	गाज़ीपुर
gayatri	गायत्री
gayitri	गायत्री
gaytri	गायत्री
gidgidate	गिजगिगेट
ginate	गिनटे
ginte	गिनते
girkar	गिरकरार
girijaghar	गिरिजागर
girjaghar	गिरजाघर
girijagharon	गिरिजाघरों
girjagharon	गिरजाघरों
girati	गिराती
girti	गिरती
girish	गिरिश
guan	गुआन
gujar	गुजर
gujarata	गुजरता
gujarta	गुजरता
gujarate	गुजराते
gujarte	गुजरते
gujarana	गुजरना
gujarna	गुजरना
gujara	गुजरा
gujare	गुजरे
gutta	गुट्ता
gthalidar	गथलीदाा
guthalidar	गुथलिदार
gudna	गुदना
gumaan	गुमान
guman	गुमान
gulshan	गुलशनन
gunga	गुंगा
grihnagar	गृहनागर
gruhnagar	गृहनार
galaxion	गैलक्शियन
galaxiyon	गैलक्सियों
galaxyon	गैलक्सियों
gochar	गोचर
gouchar	गोछर
godara	गोदरा
gopichand	गोपीचंद
gomake	गोमकक
gomke	गोमके
goel	गोएल
goyal	गोयाल
gosvaami	गोस्वामी
gosvami	गोस्वामी
goswami	गोस्वामी
gaumukh	गौमुख
gomukh	गोमुख
gaumutr	गौमूत्र
gaumutra	गौमुत्र
gowmutra	गुयूम्र
granthiyaan	ग्रांथियां
granthiyan	ग्रांथियां
grandhiyon	ग्रांियों
granthiyon	ग्रंथियों
greest	ग्रीस्ट
greist	ग्रिस्ट
grist	ग्रिस्ट
greg	ग्रेग
granite	ग्रेनिट
grenite	ग्रेनीट
grandson	ग्रांडसन
gross	ग्रॉस
ghataatop	घटाटोप्स
ghatatop	घटटटोप
ghataayaa	घटाया
ghataya	घटाया
ghanakar	घनाकर
ghabrahat	घबराहट
ghasi	घसी
ghisai	घिसाई
ghisi	घिसी
ghise	घिसे
ghumakkadi	घुमक्कडी
ghumakkdi	घुमक्कीी
ghumakkadon	घुम्ककाडों
ghumakkaron	घुमाककारों
ghumakkdon	घुमाकदों
ghummakkadon	घुम्यकदाडों
ghumaan	घुमान
ghuman	घुमान
ghoonsa	घूंसा
ghunsa	घुंसा
ghongha	घोंघा
ghontane	घोंटने
ghontne	घोंटने
ghot	घोट
ghodi	घोड़ी
ghost	घोस्ट
changul	चंगुल
chand	चंद
chandan	चंदन
chandana	चंदना
chandu	चंदू
chandon	चंदों
chandrabali	चंद्रबाी
chandramaon	चंद्रमाओं
chakatte	चकतते
chaktte	चकतते
chakkar	चक्कार
chkkar	चक्कार
chakshu	चक्षु
chatagaon	चटागाओव
chatgaon	चटगांव
chadhane	चढ़ाेे
chadhne	चढ़ने
chaturdik	चतुर्दिक
chatunshkoniy	चतुनकककनी
chatushkoniy	चतुटककोिय
chatushkoniya	चतुटककोिय
channa	चन्न
chabate	चबाते
chabutare	छाबूतरे
chabutre	छाबूत्रे
chamakna	चमकना
chamkana	चमकाना
charas	चारस
charit	चरित
charcha	चर्चा
churcha	चर्चा
charchaon	चर्चाओं
chalenge	चलेंगे
chlenge	छ्लेंगे
chahunaur	चौहनौर
chahunor	चौहूर
chanval	चंवाल
chanwal	चंवाला
chachaji	चच़ी
chadar	चादर
chadaron	चााारों
chadron	चद्रों
chan	चन
chanan	चनन
chaplusi	चापलिस
chayal	चायल
char	चर
charon	चारों
charge	चार्ग
chart	चर्ट
charton	चार्टन
charts	चार्टस
chaalit	चालित
chalit	चलित
chikitsak	चिकित्सक
chikitsakon	चिकित्सकों
chikhali	चिखली
chiththi	चित्ठी
chitthi	चिट्ठी
chithhi	चित्
chiththi	चित्ठी
chitthi	चिट्ठी
chidchidapan	चिड़चिड़पन
chidchidapan	चिड़चिड़पन
chidhate	चिढ़ते
chidhte	चिड़ते
chithrkar	चित्रकार
chitrkar	चित्रकार
chipakane	चिपकने
chipakne	चिपकने
chipkane	चिपकाने
chimati	चिमटी
chimti	चिमटी
chillane	चिललान
chee	चीय
chi	ची
chuka	चुका
chune	चुने
chunar	चुनर
changed	चंगेद
chetti	चेत्ती
chennai	चेनि
chero	चेरो
chest	चेस्ट
championship	चंपियोपिप
chor	चरर
choro	चोरो
choron	चोरों
chauk	चौक
chowk	चौर
chauka	चौका
chuka	चुका
chaukiyan	चौकियां
chauki	चौकी
chaukhate	चौखटे
chauguni	चौगुनी
chauda	चौड़ा
chaudah	चौदह
chaudahavan	चौडहववन
chaudhavan	चौधहवन
chaudhawan	चौधहवन
chaupati	चौपती
chupaty	छुपत्य
chaupal	चौपाल
chaurai	चौराई
chausinga	चौसिंगा
chausingha	चौसिंघा
chhagan	छगनन
chhabi	छाबी
chhalla	छल्ला
chhallaa	छल्ला
chhaviyaan	छावियां
chhaviyan	छावियां
chhavi	छावी
cheh	चीह
chhah	छाह
chehon	चेहों
chhahon	छाहों
chhai	छाई
chhagla	छगला
chhajan	छज़न
chhaati	छाती
chhati	छती
chhaapemaar	छापेमार
chhapemar	छापेमर
chheenk	छींक
chhink	छींक
chink	चिंक
chenkein	चेंकें
chhekein	छेकें
chhinke	छींके
chhinky	छींकी
chinke	चिंके
chhudaane	छुड़ाने
chhudane	छुड़ने
chhupakar	छुपाकर
chhupkar	छुपकार
chhupkr	छुपकर
chhupata	छुपता
chhupta	छुपता
chhuptaa	छुपता
chhura	छुड़ा
chhuraa	छुड़ा
chhuree	छुरी
chhuri	छूरी
chhure	छुरे
chhootane	छूटने
chhutane	छुटने
chhutne	छुटने
chheter	छितेरे
chhetr	छेत्र
chhetter	छितेटर
chhetri	छेत्री
chhetthari	छेत्ारी
chhetthri	छेत्ठरी
chai	चाइ
chhai	छाई
chhe	छी
jagaega	जगाएगा
jagayega	जगाएगा
jaghaega	जगाएगा
jgaayega	जगाएगा
jgayegaa	जगाएगा
jajaon	जाजाओं
jajon	जाजों
jad	जद
jadd	जद्ध
jaddit	जद़ित
jadeite	जड़ेते
jadet	जाेेत
jadit	जदित
jadein	जा़े
jaden	जा़े
jatara	जतारा
jatra	जतर्
jataati	जताती
jatatee	जताती
jatati	जातती
janagananaa	जनाानना
janaganna	जानगनन
jangadnaa	जांगड़ना
janganana	जानगना
janganna	जानगना
janajagran	जनजाग्रण
janjaagran	जनजाग्रण
janjagran	जनजाग्रण
january	जननूरी
janahaani	जनहानी
janahani	जनहानी
janhaani	जन्ानी
janhani	जन्हनी
jnhaani	जनहानी
jamaate	जमाते
jamaati	जमाती
jamati	जमती
jamaaya	जमाय
jamaeya	जमाई
jamaya	जमाय
jamayaa	जमाया
jamuai	जमुआई
jamuei	जमुई
jamui	जमुई
jai	जा
jay	ज्य
jaidayal	जयदयल
jayadayal	जयययाल
jaydayal	जययदाल
jaibaan	जयबानन
jaiban	जैबान
jaybaan	जययबनन
jayalalita	जयललिता
jayalalitaa	जयललिता
jayalalithaa	जयललिता
jaylalita	जयललिता
jarakh	जररख
zarakh	जररख
jarda	जर्दा
jardaa	जर्दा
zarda	जर्दा
jalagati	जलगात
jalgati	जलगाी
jalgti	जलगती
jalte	जलतें
jalbharav	जलभरवव
jalbhraav	जलबरवव
jalbhrav	जल्भराव
jalvaayu	जलवायु
jalvayu	जलवायु
jalesar	जलेसर
jasmeet	जस्मतत
jasmit	जस्मति
jassee	जस्सी
jassi	जस्सी
jamaanaa	जमाना
jamana	जमाना
zamaanaa	जमाना
zamana	जमाना
jaljale	जलजलल
zalzale	जल्जला
zee	जी
jubaan	जुबान
juban	जुबान
zuban	जुबान
jaanch	जांच
jaaunch	जाउंच
janch	जांच
jaunch	जौंच
jaagriti	जागृति
jagriti	जगगीति
jagruti	जगरूति
jajamau	जजमाऊ
jajmau	जजमाऊ
jajmauu	जजमाऊ
jaat	जात
jat	जत
jaatak	जातक
jatak	जतकक
jaatakon	जातकों
jaatkon	जातकों
jatakon	जातकों
jaatiyon	जातियों
jatiyon	जातियों
jaankaaron	जानकारों
jaankaron	जानकररों
jankaron	जनकारों
jaanam	जन्म
janam	जन्म
jaayke	जायक
jayke	जायक
jaawar	जावर
zawar	जावर
jing	जींग
gin	गिन
jeen	जीन
jin	जीन
ginee	गिनी
jinee	जीनी
jini	जीनी
geneva	जेनेवा
jeneva	जननेवा
jiniva	जीनीव
gypsy	जिप्पी
jimme	जिम्मे
jiya	जीय
gic	निस
gr	ग्र
gm	जीएम
gsm	ज्सम
gtod	ग्टोड
gtor	ग्टोर
jeetod	जीतोद़
jitod	जीतोद़
jean	जीन
jeen	जीन
jin	जीन
jeenon	जीनों
jinon	जीनों
jeepney	जिपेन
jipani	जिपानी
jeeyo	जीयो
jio	जीयो
jiyo	जीयों
jeera	जीरा
jira	जीरा
jeevant	जीवंत
jivant	जीवंत
jeevan	जीवन
jeewan	जीवान
jivan	जीवन
jiwan	जीवन
jeevanshaili	जीवनशैलि
jivanshaili	जीवनशैली
jeevniyaan	जीवनियां
jivaniya	जीवनीय
jivaniyaan	जीवनियां
jivaniyan	जीवनियां
jeevraaj	जीवराज
jivraj	जीवराज
jua	जुआ
jue	जुए
juye	जूए
jutee	जुटी
juti	जूति
judaai	जुदाई
judae	जुदाई
judai	जुदाई
judaai	जुदाई
judai	जुदाई
junoon	जुनूं
junun	जुनून
junooni	जुनूनी
jununi	जुनूनी
jubair	जुबैैर
juber	ज़ुबैर
zubair	जुबैैर
juraab	जुराब
jurab	जुराब
julaahon	जुलाहों
julahon	जुलाहों
julmon	जुल्मों
zulmon	जुल्मों
jood	जूद
jud	जुद
junagadh	जूनागढ़
junagarh	जूनागढ़
junior	जुनियर
jealous	जेलौस
juloos	जुलूस
julus	जुलुस
jetha	जेता
jenner	जननर
generic	जनरेटिक
jenrick	जेनरिक
generat	जनररट
generate	जनरेट
jenee	जीनी
jenni	जेनी
jenny	जेनी
james	जमीस
jeremy	जेरेमी
gerome	जीरोम
jerome	जीरोम
jacks	जैक्स
jain	जैन
gene	गीने
jaine	जाइने
jaino	जैनो
jainon	जेनों
jerry	जेरी
jasper	जसपपर
jogging	जोगिंग
johnson	जॉनसनन
jobs	जोब्स
jockey	जोकी
joki	जोकी
jokhim	जोखिम
joddta	जोड़ता
jodta	जोडतत
jorhta	जोड़ता
jodiyon	जोदियों
jodo	जोदो
jaun	जौरं
gyatavya	ज्यातव्य
gyatvy	ज्ञातव्य
gyapit	ज्ञापित
jyotiba	ज्योतिबा
joint	जोइंट
jvar	ज्वर
jwar	ज्वर
jvaaron	ज्वरों
jvaron	ज्वरों
jwaron	ज्वरों
jewellers	ज्वेलर्स
jh	झे
jha	झा
jhalakti	झलकति
jhalkati	झलकात
jhalla	झल्ाा
jhankana	झांकना
jhankna	झांकना
jheel	झील
jhil	झिल्
jheelon	झीलों
jhilon	झीलों
jhuthala	झुठला
jhuthla	झूठला
jhuthalane	झुठलाने
jhuthlane	झुठलाने
tankaar	टंकार
tankar	टंकरर
takara	टकााा
takra	टकरा
takaraon	टकाााओं
takravon	टक्रवों
tapakti	तपककति
tapkati	तपकाती
time	टीमे
timer	टाममर
taoo	ताऊ
tau	तुऊ
tapoowo	टपूपों
tapuon	टपपयंं
tapuwo	टपूू
tied	टीयड
tired	तिरर्ड
tyred	टिरर्ड
tarch	तर्क
torch	टॉर्च
tik	टीक
teap	टिप
tip	टिप
tippanikar	टिप्पनिकार
tippnikar	टिप्पनिकार
tivolee	तिवोली
tivoli	तिवोली
teekamgarh	टीकामगढ़
tikamgarh	तीकामगढ़
teekon	टीकों
tikon	टीकों
two	तू
tension	टेंशन
tenis	टेनिस
tennis	टेनिस
taste	तस्ते
test	टेस्ट
tasting	टास्टिंग
testing	टेस्टिंग
tainin	टेनियन
tenin	टेनिन
tanish	तनिश
tennis	टेनिस
taboo	तबबू
taiboo	तैबूबू
taobao	ताबाबा
tonic	टननिक
tonga	टोंगा
toka	टोका
tuesday	टुस््ड
tuning	ट्यूंग
tuberculosis	टब्रूक्लोसिस
tuberkyulosis	टुब्रुक्लोयेसिस
truck	ट्रक
trangistor	ट्रांजिस्टर
tranjister	ट्रांजिस्टर
transistor	ट्रांसिसटटर
transfer	ट्रांसफोर
tribunal	ट्रिब्नूलन
tribunal	ट्रिब्नूलन
trubyunal	ट्रिब्यूनल
truth	त्रुथ
tuth	तुथ
traded	ट्रेडिड
trabal	ट्राबल
trebal	ट्रेबल
trouble	ट्रबल
traip	ट्रिप
trap	ट्ररप
trot	ट्रोट
trott	ट्रोट
thakkar	ठक्कार
thakkr	ठक्कर
thaharne	ठहरनने
thahrane	ठहराने
theharne	ठहराने
thikane	ठिकने
thumari	थुमारी
thumri	थममरी
theinga	थीइगा
thenga	ठेंगा
thengaa	ठेंगा
daglas	डाग्ाास
douglas	डुगलसास
dabhara	दभररा
dabhra	दभरा
dabhoi	दभूई
dam	दम
dum	दूम
darate	डराते
daratey	डरतते
daravani	दरवानी
darawani	दरवानी
dravani	द्रवानी
down	डून
daak	दक्
dak	दक
daka	डका
dabi	दबी
dabolim	डबोलिम
dinosaur	डिनोसोर
diaries	डायरिज
dit	दित
depthiriya	डिप्ठिरिया
diphtheria	दिप्ेरीयय
de	दी
dealership	डेलर्शिप
dvc	ड्वि
dubaana	दुबाना
dubana	दूबना
dubona	डूबनन
dulne	दुलने
doonarpur	दुनारपुर
doongarpur	दूंगरपुर
dungarpur	दंगरपपरर
dungerpur	दंगरपपर
dubana	दूबना
dubna	दूबना
dangerous	डंगररसस
daisy	दैश्य
dazy	दज्ञ
deji	दीजी
deputy	डिपिटी
davidson	द्विसन
devidson	डिविड्सन
davey	द्वे
devi	दिवी
dewey	द्वेय
destination	डिस्टेनेशन
datson	दत्सों
datsun	दत्सून
daddy	दद्ध
dark	डर्क
dork	डोर्क
dose	डोस
domenic	डोमेनिक
doranda	डोरंडा
dolane	डोलने
dolne	डोलने
dual	डुयल
duak	दुक
duke	दुके
drame	ड्रम
dramen	ड्रमेन
drager	ड्रेगर
dredger	ड्रेगर
dreijer	ड्रीजर
dhakaal	धकाल
dhakal	धकाल
dhakkal	धक्कल
dhkal	धकाल
dhale	ढाले
dhoondh	धूंध
dhundh	धुंध
dhoondhata	ढूंधता
dhundhata	धूंधता
dhundhta	धूंधता
dhoondhi	ढूंधी
dhundhi	धुंधि
tanjavur	तंजावूर
thanjavur	तंजावूर
tantr	तंतर
tantra	टंत्र
tantrikao	तंत्रिकाओं
tantrikaon	तंत्रिकाओं
tantro	टंत्रों
tantron	तंत्रंं
tagade	तगड़े
tagde	तगदे
tadipaar	तदीपपार
tadipar	तदीपप
tani	तनी
tapan	टपप
tarafa	तराफा
tarfa	तरफा
tarabganj	तारबगंज
taras	तरसस
taraash	तराश
tarash	ताराश
tarashay	ताराशय
tarashe	ताराश
tareeko	तरीकों
tariko	तरीकों
tark	तर्क
tarkvaad	तर्कवाद
tarkvad	तर्कवाद
tarkwaad	तर्कवाद
tarko	तरकोक
tarkon	तर्कों
talabgaar	तालागार
talabgar	तालागार
talbagaar	तालबागर
talbagar	तालबागर
talawe	तलावे
talve	तलवे
talawon	तलावंं
talvon	तलवों
tahakhana	तहखाना
tahkhaana	तहखाना
tahkhana	तहखाना
taantaa	टांता
tanta	टांता
tambe	तंबे
tanbe	तंबे
taaja	ताज़ा
taajaa	ताजा
taaza	ताज़ा
taja	ताजा
taza	ताजा
tansen	टंसें
taapmaanon	तापमानों
tapmano	तप्पानों
tapmanon	तप्पानों
taapti	तापति
tapti	तप््
tarabai	तरबाई
taseer	तसीयर
tasir	तसीर
taahi	ताही
tahi	तहह
tikone	टिकोन
tirupati	तिरुपति
tiwari	तिवाड़ी
ti	टी
teer	टीरर
tir	तिर
teeron	टीरों
tiron	तिरों
tirthatan	तीर्थनतन
tungnath	टुंगनाथ
tughlaq	तुघलाक
tuglak	तुग्लक
tughlakabad	तुल्खलाबाद
tughlaqabad	तुल्खलाबाद
tuglakabad	तुल्कलाबाद
tugalaki	तुगलााक
tugalki	तुगाली
tuglaki	तुग्लाकी
tufail	टूफैइल
tejaji	तेज़ाज
teji	तेज़
tel	टेल
telon	टेलों
to	तो
toh	तोह
taul	टुरल
tyohaar	त्योहार
tyohar	त्योहार
tyoihar	त्योहार
tyauharon	त्याहारों
tyoharon	त्योहारों
tyoiharon	त्योहारों
trijata	त्रिजता
trijta	त्रिजता
triya	त्रिय
tremasik	ट्रेमासिक
trimasik	त्रिमासिक
tse	त्से
thaki	ठकी
thki	थकी
tharti	थररी
thirty	थर्टी
thane	ठाने
thaanvi	थाववी
thanvi	थाववी
theateron	थीटरों
theatron	थीत्रों
theaters	थिटर्स
theater	थिटर
theatre	थीतरर
theateron	थीटरों
theatron	थीत्रों
thitron	थित्रों
theaters	थिटर्स
theatrs	थिटर्स
thiyeters	थियोट्रर
thirake	थिरकक
thirke	थररके
thief	थीप
then	ठें
theni	थेनी
thailee	थैली
thaili	थैली
thaile	थाइले
dang	डंग
danga	डंगा
dangon	डंंगों
dampati	दमपाती
danpati	दनपाती
dampatiyon	दंमपतियों
dampattiyon	दंपत्तियों
danptiyon	दंपपितियों
dadreva	दद्रेवा
dadrewa	दद्रेवा
damoh	दमोह
dardara	दर्दार
dardraa	दर्दरा
durdhara	दूर्धार
darmiyaan	दरमियां
darmiyan	दर्मियां
darjano	दर्जनों
darjanon	दर्जनों
darp	दर्प
darra	डराा
dalbadal	दलबादल
dalbadl	दलबादल
dali	दली
dastaanaa	दस्ताना
dastana	दस्ताना
dastavej	दस्तावेज
dahan	दहनन
dahal	दहलल
da	दा
daakhil	दाख़िल
dakhil	दाखिल
daakhile	दाख़ले
dakhile	दख़लले
daataa	दाता
data	दताा
dadari	ददरी
daanshil	दंशील
danshil	दंशील
daabholkar	दभौलककार
dabholkar	दभोलककर
damale	दमली
damle	दमली
dayitv	दयित्व
dayitva	दयित्व
dayitwa	दयित्व
dayitvon	दाित््वंं
dayityon	दायित्यों
darul	दरुल
daav	दाव
daaw	दाव
dav	द्व
daw	द्व
daah	दाह
dah	दह
dikhla	दिखला
dikhlaa	दिखला
dikhaaiye	दिखाइए
dikhaiye	दिखाइए
dikhaai	दिखाई
dikhai	दिखाई
dikhayi	दिखाई
dikhaaee	दिखाई
dikhaai	दिखाई
dikhaain	दिखाइने
dikhaee	दिखाई
dikhai	दिखाई
dikhayin	दिखाइयों
dikhai	दिखाई
dikhayi	दिखाई
dikhaai	दिखाई
dikhae	दिखाए
dikhai	दिखाई
dikhayi	दिखाई
dita	दीता
ditaa	दिता
dinaank	दिनांक
dinank	दिननंक
dirham	दीरहम
dilaaye	दिलाए
dilaye	दिलाए
deewani	दीवानी
diwani	दीवानी
divy	दिव्य
divya	दिव्य
divyata	दिव्यतत
divya	दिव्य
deepan	दीपन
deepn	दीप्न
dipan	दीपन
deepsingh	दीप्सिंह
dipsingh	डिपपिंघ
deepika	दीपीका
dipika	दीपीका
deeya	दीय
diya	दिय
dukaanon	दुकानों
dukanon	दुकानों
dukke	दुक्के
dukhan	दुखनन
dukhit	दुखित
dukhiyon	दुखियों
dukhon	दूखों
dubhashiyon	दुभाषियों
durgun	दुर्गुण
durghatna	दुर्घटना
durghtna	दुर्घटान
duneerti	दुनीर्ति
durniti	दुर्निटी
durbhiksh	दुर्भीक्ष
duvidhaaen	दुविधाएं
duvidhaayein	दुविधाएं
duvidhaen	दुविधाएं
duwaidhaayein	दुवेधाएं
dune	दुने
doordarshan	दूरदर्शन
durdarshan	दूरदर्शन
dradh	दृद्ध
dridh	दृद्ध
dekhoge	देखोजे
denevaali	देनेवाली
denevali	देनेवाली
denewaali	देनेवाली
denewali	देनेवाली
deonar	डिनर
devnaar	देवनार
devnar	देवनर
devaapur	देवापुर
devapur	देवापुर
devi	दिवी
devisingh	डेविसिंग
devisinh	डिविसिंह
deshkaal	देशकाल
deshkal	देशकाल
deshke	देशके
desai	देसाई
doge	डोगे
dvadash	द्वदाश
dwaadas	द्वदसस
dvivedi	द्विवेदी
dwivedi	द्विवेदी
dhande	धंडे
dhandhe	धंडे
dhndhe	धंधे
dhandhon	धंधों
dhandon	धंडों
dhakelte	धकेलते
dhkelate	धकललते
dhatana	धातना
dhatna	धतना
dhankuber	धनकूखरे
dhanadhany	धनाढ़न
dhandhaanya	धंधान्य
dhandhany	धंधान्य
dhandhanya	धनधान्य
dhamkaataa	धमकाता
dhamkata	धमकका
dhamm	धम्म
dhamma	धम्म
dhammaa	धम्मा
dharmnath	धर्मनाथ
dharmraj	धर्मराज
dharmesh	धर्मेश
dhasmaanaa	धस्मनन
dhasmana	धस्मनन
dhaak	धाक
dhak	धक
dhaaga	धागा
dhaagaa	धागा
dhaga	धागा
dhaatuein	धातिएं
dhaatuyein	धातियां
dhtuen	धत्युं
dhaarak	धारक
dharak	धरकक
dhaari	धारी
dhari	धारी
dhuan	धुना
dhunaai	धुनाई
dhunai	धुनीई
dhuriya	धूरीया
dhuriyaa	धुरिया
dhuni	धुनी
dhairyavaan	धैर्यवान
dhairyawan	धैर्यवान
dhiryavan	धिर्यवाण
dhiryawaan	धीर्यवान
dhokebaaj	धोखेबाज
dhokebaaz	धोखेबाज
dhokebaj	धोखेबाज
dhokebaz	धोखेबाज
dhokhebaaj	धोखेबाज
dhokhebaj	धोखेबाज
dhona	ढोना
dhonaa	धोना
dhoraaji	धोराजी
dhoraji	धोराजी
dhoron	धोरों
dhyeyavaadi	ध्याववादी
dhyeywadi	ध्यववादी
dyeyvadi	द्यववादी
dhrupad	ध्रुपद
drupad	द्रपप
nandanvan	नंडनवान
nadsa	नडसस
naksal	नक्सल
naxal	नक्सल
naksalavaad	नक्सलावाद
naksalwaad	नक्सलवाद
naksalwad	नक्सलवाद
naxalvaaad	नक्लवााद
naxalwaad	नक्लवााद
naksaliyon	नकसालियों
naxaliyon	नक्सलियों
naksali	नक्सली
naxali	नक्सली
nagaada	नगाद़
nagaadaa	नगाा़
nagaaraa	नगारा
nageene	नगीीन
nagine	नेगिन
najarandaaj	नजरअंदाज
najarandaaz	नजरअंदाज
nazarandaaj	नजरअंदाज
nazarandaaz	नजरअंदाज
nazarandaz	नजरअंदाज
najraane	नज़रने
nazraane	नज़रने
najariyon	नज़रियं
najriyon	नज़रियों
najron	नजररं
najeeb	नज़ीब
najib	नज़िब
najibabaad	नाज़बबबाद
najibabad	ना़ीबाबाद
najeem	नजीम
najim	नाजिम
nazeem	नजीमम
nana	नन
nanaa	नना
nna	न्न
nanhe	नन्हे
nanhein	नन्हें
nabj	नब्ज
nabja	नब्ज
nabz	नब्ज
namkeen	नमकीिन
namkin	नमकीन
narnaari	नर्णारी
narnari	नर्नारी
narbhakshi	नर्भक्षी
naram	नररम
narm	नर्म
narmi	नर्मी
narsanhar	नरसंहर
narsanharon	नरसंहरों
november	नोवंबर
navketan	नवकेटन
navjaagaran	नवजजगरण
navjagran	नवजजग्रण
navdha	नवधा
navvadhoo	नववाधा
navvadhu	नववाधा
nava	नवा
navaa	नवा
navate	नवाते
navanagar	नवानगर
nawanagar	नवानगर
navya	नव्य
naseem	नसीम
nasim	नसीम
nights	नाइट्स
nitrous	नाइट्रास
nineteez	नीनीतीज
nineties	नीनटटीज
ninties	निंटीज
nau	नौऊ
nauu	नौर
naakaam	नाकम
nakam	नकम
naagrik	नाग्रिक
nagarik	नागरिक
nagrik	नागरिक
nagin	नगगिन
nadep	नडीपप
nanak	ननक
nanavati	नानावती
napane	नपपने
napne	नपपी
napa	नपप
naam	नाम
naamdhari	नामधारी
namdhari	नंधारी
namankano	नमानकानों
namankanon	नमानकानों
namavaliyon	नमावलियों
naamo	नामो
namo	नमो
nayak	न्यक
naraji	नाराजी
naraingarh	नारीनगऱ
narayangadh	नार्यागगढ़
narayangarh	नार्यणगढ़
naasar	नासर
nahargadh	नहर्गढ़
nahargarh	नहररगढ़
nikalegi	निकलेंगी
nikalogi	निकललगगी
nikaalani	निकालनी
nikaalni	निकालनी
nikalani	निकलाी
nikalni	निकलनी
nicki	निकी
nicky	निकी
niki	निकी
niketan	निकेटन
nikhar	निखर
nikhari	निखरी
nigar	नीगर
nigger	नाइगर
nichala	निचला
nichalaa	निचला
nichla	निचला
nitiyon	नीतियों
nitya	नित्य
nityaa	नित्य
nidhaan	निधान
nidhan	निधान
nipatara	निपटारा
niptaara	निप्ाराा
niptaaraa	निप्ारा
niptara	निपटारा
niyanta	नियंता
niyantaa	नियंता
niya	नीय
niyaa	निया
nirdeshika	निर्देशिका
nirdeshikaa	निर्देशिका
nirdhaarit	निर्धारित
nirdharit	निर्धारित
nirbaadh	निर्बाध
nirbadh	निर्बध
niveshakartaa	निवेशकर्ता
niveshkarta	निवेशकर्ता
niveshkartaa	निवेक्षरता
nischal	निस्चल
nishchal	निष्चल
nishnaat	निश्नत
nishpaap	निष्पप
nihalaani	निहालनी
nihlaani	निहाानी
nihlani	निहाननी
nihaalchand	निहालचंद
nihalchand	निहालचंद
neechaaee	नीचाई
nichaai	निचाई
neat	नीट
neet	नीत
neetiyon	नीतियों
nitiyon	नीतियों
neelagaay	नीलगाय
nilgai	नीलगाई
neelaabh	नीलाभ
nilaabh	नीलाभ
nilabh	निलाभ
nuskhe	नुस्खे
noon	नू
nun	न्न
noobiyaa	नूबिया
nubiya	नुबिया
nrityashaili	नरित्यशशली
nrutyashaili	नृत्यशिली
nrityon	नृत्यों
nrutyon	नृत्यों
neco	नीको
neko	नेको
nectar	नेक्टार
neg	नीग
nega	नेगा
networking	नेटवर्किंग
neto	नेटो
neta	नेता
nemo	नीमो
nelsan	नेल्सन
nelson	नेल्सन
nations	नेशंस
nehara	नेहरा
nehra	नेहरा
naino	नीइनो
nano	ननो
naivedh	नेवेध
naivegh	नववेघ
nevedya	नेवेदय
nominate	नॉमिनेट
naukari	नौकरी
naukri	नौकरी
nokari	नोकरी
nokri	नोकरी
notes	नोटेस
nora	नोरा
nori	नोर
nauner	नॉनर
nauvahan	नुवाहन
naushad	नौषद
panchaang	पंचांग
panchang	पंचंग
punchang	पंचंग
punjab	पुंजब
punjabiyon	पूंजबियों
pantar	पंतर
panter	पंंरर
punter	पंंरर
pakaayein	पकाएं
pakaayen	पकाएं
pakaen	पकाएं
pakayen	पकाएं
pakaude	पकौड़े
pakshapat	पक्षापत
pakshpaat	पक्षपात
pakshpat	पक्षपात
pagabadha	पगबबध
pagbadha	पाबबध़
pagalaa	पगला
pagla	पगला
pachaataa	पचाता
pachata	पचाता
patakkar	पटककार
patkathaayein	पटकथाएं
patkathaein	पटकथाएं
patkathayen	पटकथाएं
patki	पतकक
pataraani	पतराणी
patrani	पत्रानी
patavaari	पतवारी
patwari	पतवारी
pataakshep	पााक्षपप
patachep	पताचीप
patakshep	पाकाष्प
patiya	पतीय
patiyaa	पतिया
padaraunaa	पदररना
padrauna	पद्रोण
padega	पदेगा
padegaa	पदेगा
padha	पध़
padhaa	पध़ा
padhaataa	पढ़ता
padhata	पढ़ता
patili	पटीली
padamawati	पदममवती
padmavati	पद्मावती
padmawati	पद्मावती
padadhikari	पदाधिकारी
panapnaa	पनपना
panpana	पनपना
panaamaa	पणमा
panama	पनम
paneer	पनीर
pammi	पममी
pammu	पम्मू
pummi	पम्म
pummy	पम्म
pardesiyon	पार्देशियों
pardesi	परदददे
parva	पर्व
parvaa	पर्व
parwa	पर्व
parwaa	पर्ा
paraadheen	पराधीन
paraadhin	पराधीन
paradheen	पराधीन
paradhin	पराधीन
parikalpit	परिकल्पित
parimal	परिमाल
parishad	परिष्द
parishadiy	परिशादीय
parishadiya	परिशादीय
parishadon	परिशादों
parikhaen	परीक्षाएं
parikshaayein	परिक्षाएं
parikshaen	परिक्षाएं
parosane	परोसने
parosne	परोसने
parda	परदा
pardaa	परदा
purple	परपलल
palatne	पलटने
paltane	पलटान
palaari	पलारी
palari	पलारी
pale	पले
palmonari	पालमनोरी
pulmonary	पल्मोनरी
plus	प्लस
pulse	पुलस
pashtun	पश्टुन
pashtuun	पश्तुमुं
pahan	पहन
pehan	पहनन
pahantaa	पहनता
pahnata	पहनाता
pehnate	पहनते
pahanate	पहनते
pahante	पहनते
pehnate	पहनते
pahnaakar	पहनाकर
pahnakar	पहनकर
pehnakar	पहनकर
pahnaati	पहनाती
pahnati	पहनती
pehnati	पहनती
pahani	पहनी
pahni	पहनी
pehni	पहनी
pahno	पहनो
pehno	पहनों
pahla	पहला
pahlaa	पहला
pehla	पहला
paheliyaan	पहेलियां
paheliyan	पहेलियां
paheliyon	पहेलियों
pide	पीड़
pied	पीईड
pythagoras	पैठागागरस
pythogaras	प्थोगागसस
paakhandi	पाखंडी
pakhandi	पखंडी
paathshaalaayein	पाठशालाएं
pathshalayein	पाठशालाएं
pathshalayen	पाठशालाएं
paathyakram	पाठ्यक्रम
pathyakram	पठययक्रम
pathykram	पाठ्यक्रम
paathyakramon	पाठ्यकर्मों
pathyakramon	पाठयक्रमों
pathykramon	पाठ्यक्रमों
population	पॉपुलेशन
pailot	पैलोट
pilot	प्लोट
pailoton	पैलोटों
piloton	पिलोटों
paarampariktaa	पांरर्यकता
paramparikata	परंपरायकतत
paramparikta	परंपरायकत
parnel	पर्नेल
parnell	पर्नेल
parleron	पार्लरों
parloron	पार्लों
parlouron	पार्लररं
paarshad	परश्द
parshad	परशदद
paarshadon	पार्शदों
parshadon	परशादों
parshdon	परश्दों
policy	पुलिसी
pinta	पिनता
pintaa	पिनता
piega	पीएगा
piyegaa	पीएगगा
pic	पिक
pick	पिक
pik	पीक
piki	पीकी
piky	पिकी
picture	पिक्चर
pigmentation	पिग्मेंटशन
pigs	पिग्स
pichde	पीचंड
pichhade	पिछड़े
pijja	पिज़्
pizza	पिज़्ज़
pitaamaha	पीतामा
pitamah	पीतामह
pipra	पिपर
pipraa	पिपरा
pipli	पपपलल
pearson	पररसन
pierson	पियर्सन
peary	पीरी
piyari	पियारी
pisaai	पिसाई
pisai	पिसाई
pihaani	पिहानी
pihani	पिहानी
pib	पिब
pr	प्र
pml	प्एम
pmo	प्यू
pmch	पीएूची
psv	प्वव
peaking	पीकिंग
picking	पिकिंग
peetne	पीटने
pitne	पीटने
pedia	पीढ़य
pidiya	पीढ़य
pidiyaa	पीढ़िया
peelepan	पीलेपन
pilepan	पिलेपन
pv	प्व
pisa	पीस
putla	पुत्ल
putlaa	पुतला
putaliyaan	पुटलियां
putliyan	पुललियां
putaliyon	पुटलियों
putliyon	पुललियों
putali	पुतली
putli	पुतली
putale	पुताले
putle	पुटल
putin	पुटिन
putul	पुतुल
punargathan	पुनर्गानन
puna	पून
puraane	पूराने
purane	पूराने
puru	पूरू
purjon	पूर्जों
purzon	पूर्जन
pulam	पुलम
pushkin	पुष्किन
pushkarana	पुष्करण
pushkarna	पुष्करण
pushkarnaa	पुष्करण
pushp	पुष्य
pushpa	पुश्प
pushpa	पुश्प
pushpaa	पुश्प
pushpit	पुश्पित
pushpon	पुषपों
poonjikaran	पूंजीकरण
punjikaran	पूंजीकरण
poojaapaath	पूजापा
poojapath	पूजापठ
pujapath	पुजापठ
pooranpur	पूरणपपर
puranpur	पुराणपुर
purvaabhaas	पूर्वाभास
purvaabhas	पूर्वाभास
purvabhaas	पूर्वभास
purvabhas	पूर्वभास
pendulam	पेंडुलम
pendulum	पेंडुल्म
peg	पीग
pages	पेजस
pajej	पजेज
pace	पसस
pes	पेस
pastry	शात्र्य
pangolin	पंगोलिन
pengolin	पेंगोलिन
packard	पैकर्ड
package	पककेज
packageon	पैकेजन
packagon	पैकागों
packajon	पैकजजों
paim	पैम
pam	पम
paratrooper	पररत्रपप
peratrupers	पररार्पर्स
paranormal	पररोनममल
peranormal	पैरोनरमॉ
paraffin	पराफीन
parafin	पराफिन
perafin	पररफीन
parabola	पररबोल
perabola	पैराबोला
polimer	पॉलिमर
polymer	पॉलिमर
polishing	पॉलिशिंग
pokar	पोकर
poker	पोकरर
polish	पुलिश
poshit	पोशित
posta	पोस्टा
pau	पौऊ
pyade	प्यादी
prakriya	प्रकररय
prakshepak	प्रक्षेपक
pratigya	प्रतिग्ञ
prtigyaa	प्रतिग्य
pratibhutiyan	प्रतिभूतियां
pratiyon	प्रतियों
prativaad	प्रतिवाद
prativad	प्रतिवाद
prativadi	प्रतिवादी
pratishat	प्रतिशात
praneet	प्रणीत
pranit	प्रणित
prapaat	प्रपात
prapat	प्रपा
prapaaton	प्रपाटों
prapaton	प्रपटों
prabodhini	प्रबोधीनी
prayaasrat	प्रयस्ता
prayasarat	प्रयस्रत
pradarshan	प्रदर्शन
prardashan	प्रदर्शन
pravati	प्रवाी
pravatti	प्रवत्ती
prashaasanik	प्रशासनिक
prashasanik	प्रशासनिक
prashasnik	प्रशासनिक
prashaasanon	प्रशासनों
prashansanon	प्रशंसनों
prashasanon	प्रशासनों
prashikshu	प्रशिक्षु
prastaavon	प्रस्तावों
prastavon	प्रस्तवों
prahlaad	प्रहल्ाद
prahlad	प्रहल्द
prahasan	प्रहासन
prahsan	प्रहस्न
prahaarak	प्रहारक
praharak	प्रहारक
prahad	प्रहाद
prahlad	प्रहल्द
privacy	प्रिवाेपी
praakkathan	प्रकक्टन
prakkathan	प्रकटचान
praan	प्राण
pran	प्रण
pranon	प्रणों
prathamik	प्रथामिक
prathmik	प्राथमिक
praathmikata	प्राठमिकता
prathmikta	प्राथमिकता
prathmiki	प्राथमिकी
pradhyapakon	प्राध्यापकों
prapt	प्रप्
prapta	प्रपप्
prapti	प्रपती
praroop	प्ररूप
prarup	प्ररूप
priyamani	प्रियमानी
proof	प्रप
pruf	प्रप
prekshakon	प्रेक्षकों
prem	प्रीम
premlata	प्रेमलाटा
prema	प्रीमा
premi	प्रीमी
profit	प्रोफिट
processing	प्रोसेसिंग
programers	प्रोग्राम्स
programmers	प्रोग्रामुस
programs	प्रोग्राम
proto	प्रोटो
propellant	प्रोपललंंट
propellent	प्रोपलेंंट
praudh	प्रौढ़
proud	प्रूड
plan	प्लान
plane	प्लाने
fund	फंद
funda	फंंड
funding	फंडिंग
fandon	फंडों
fagua	फगगु
fatane	फतने
phatane	फटने
phatne	फटने
fadfadata	फड़फाड़ता
phadphadata	फड़फड़ााा
fatehgadh	फेठहगढ़
fatehgarh	फेठहगढ़
fabti	फबबती
phabti	फबबी
farse	फरसस
pharase	फररस
pharse	फर्स
farheen	फरहीन
farhin	फरहीन
farth	फर्थ
ferth	फर्थल
pharth	फर्थ
farmion	फर्मियों
fermion	फर्मियन
firmian	फर्मियन
farookhabad	फरूखाबड़
farrukhabad	फरूखखबबड़
farukhabad	फरूखाबड़
farookhnagar	फरूखानगर
farrukhnagar	फरूखलागर
farukhnagar	फरूखनागर
falata	फलाता
falta	फललता
phalata	फलाता
falne	फलने
phalne	फलने
falitarth	फलीतार्थ
phalitartha	फलीतार्थ
falibhoot	फालीभूत
falibhut	फालीभुत
phalibhoot	फलीभाभ
favvara	फववारा
fawaara	फवारा
favvare	फववारे
fawaare	फवारे
favvaron	फववारों
fawaaron	फवारों
faisala	फैससल
faisla	फैसला
follow	फोलो
faansi	ैंससी
fansi	ैंसी
fatama	फतामा
fatma	फत्मा
faaf	फफफ
phaaph	फाफ
farsi	फररसी
forcee	फोर्सी
farm	फर्म
form	फॉरम
farmic	फर्मिक
formic	फॉर्मिक
formulae	फार्मूलाई
formule	फार्मूल
formuley	फॉर्मूलो
pharmacy	फर्मासी
pharma	ररमा
pharmon	फर्मों
farms	फर्मस
finger	िंगरर
fikra	िककरर
physician	फिजिकियन
firti	फर्टी
fisla	फिसला
fislaa	फिसला
feeder	ीदीदर
fulaaye	फुलाए
fulae	फुलाई
fulay	फुला
furti	फुर्त
phurti	फुर्ती
fus	फ्स
phoos	ूर
phus	फरस
feka	ेेका
fefada	फेफड़ा
fefda	फेफ़ा
facial	फैसिलल
fact	फैक्ट
federal	फेडररल
failkar	फैलकर
failaaiye	फैलाइये
failaea	फैलाए
failaiya	फैलायय
failaiye	फैलाइये
failegi	फैलेगी
font	फॉंट्
fogat	फोगट
phogat	फोगट
fod	फोड
phod	फोड़
foda	फोड़ा
fodaa	फोड़ा
phoda	फोड़ा
fode	फोड़
phode	फोड़
fodo	फोडोो
fodon	फोड़ंं
phodo	फोड़
fortis	फोर्टिस
fusion	फ्ूइन
fuji	फूजी
fyuji	फ्यूजी
francisca	फ्रैंसिस्क
franciska	फ्रैंसिस्का
fransiska	फ्रैंसिस्क
francisco	फ्रैंसिस्को
francisko	फ्रैंसिस्कों
fransisko	फ्रैंसिस्कों
fringe	्रिंग
friendship	फ्रेंडिश्प
frost	्ररस्ट
flin	फ्लाइन
flynn	फ्लाइन
flesh	फ्लेश
bang	बंग
bung	बंग
bangbandhu	बंंबंध
bangbhang	बंगगंंग
bangash	बंगाश
bangsh	बांग्
bantane	बंटाने
bantne	बंटने
bandhati	बाधधती
bandhti	बाधधी
bandhan	बंधन
bandhuon	बंधुओं
bamba	बंंबा
mumba	मुंबा
bakaayon	बकायों
bakayon	बाकायं
bakaul	बकौलल
bakoul	बकौल
baksa	बक्स
baksi	बक्स
bakse	बकसे
bakhshane	बख्शने
bakhshne	बख्षने
bagad	बगगड़
bagd	बाग्
bageechi	बगीची
bagichi	बगीची
bachat	बचात
bachati	बचाती
bachti	बचती
bajana	बजना
bajrangi	बजरंगी
bajaj	बजजज
batalvi	बटालवी
badhachadhakar	बढ़ाचधकरर
badata	बड़ता
badhaataa	बढ़तत
badhata	बढ़ता
badhaati	बढ़ती
badhati	बढ़ती
badhayi	बढ़ा
badhav	बढ़वव
badhotari	बढ़ोततर
badhotri	बढ़ोत्री
batlaae	बतलाई
batlaaye	बतलाए
batlae	बतलाई
batlaye	बतलाए
batlaakar	बतलाकर
batlakar	बटलाकर
badlapur	बदलापुर
badali	बदली
badli	बदली
badam	बददम
banva	बनवा
banvaa	बनवा
banaam	बनाम
banam	बन्म
bnaam	बनाम
baniya	बनिय
banu	बनू
barpaayaa	बरपाया
barpaya	बरपाया
barsa	बरसा
barsaata	बरसाता
barsaataa	बरसाता
barsata	बरसता
barhad	बरहहड़
baraat	बरात
barat	बरात
braat	ब्राट
baraamad	बरामद
baramad	बर्मद
bramad	ब्रमाद
baramade	बरममद
baramde	बर्मदे
bare	बरे
birth	बीरत
baljeet	बलजीत
baljit	बलजीत
ballabh	बल्लभ
balla	बल्ला
balli	बलिल
basava	बसवा
bastiyon	बस्तियों
bahroopiya	बहरूपीय
bahrupiya	बहरूपीय
bahamaas	बहमास
bahamas	बहमसस
bahaav	बहाव
bahav	बावव
bhav	भवव
bahavalpur	बहवालपुर
bahawalpur	बहवालपुर
bahuchara	बहुचरा
banthia	बंठिया
banthiya	बंठीय
bandhate	बंधाते
bandhte	बांधते
banbi	बांबी
bombi	बोंबी
bounceron	बाउंसरों
bowling	बोलिंग
baku	बकू
bakuu	बकूई
baag	बाग
bag	बाग
bagh	बाघ
bagabani	बागबनी
bagbani	बगबबनी
bagali	बगली
bagli	बगली
baagiyon	बागियों
bagiyon	बगगियों
baago	बागो
bago	बागो
baji	बाजी
bazi	बाजी
bajaru	बाजरू
bazaru	बाजरू
bajuon	बाजूओं
badh	बढ़
badha	बढ़ा
baadhaaon	बाधाओं
baadhaon	बाधाओं
badhaaon	बा़ाओं
badhaon	बाधाओं
baadhit	बाधित
badhit	बढ़ित
baani	बानी
bani	बनी
baapa	बापा
baapaa	बापा
bapa	बाप
bapaa	बापा
baabat	बाबत
babat	बबबत
babt	बब्त
bayern	बायर्न
byrun	ब्रून
barah	बराह
baarahamaasee	बारहममी
barahamasi	बरहहमसी
barahmasi	बारहमससी
barahsinga	बरहहसंगग
barasingha	बरसींघा
bala	बला
baalti	बालती
balti	बाल्ी
balty	बाल्टी
baldvin	बाल्ववं
baldwin	बेल्ववन
bavaji	बावजी
bavji	बावजी
baawaraa	बावरडा
bavra	बावरा
bawara	बावरड
baahulya	बाहुल्य
bahuly	बहुल्य
bahulya	बहुल्य
box	बोक्स
bikherati	बिखेरती
bikherti	बिखररती
biggest	बागेस्ट
bichhua	बिचुआ
bichhuaa	बिचुआ
biji	बीजी
busy	बुसी
buzy	बुजी
bipin	बिपिन
bilae	बिलाई
bilai	बिलाई
billa	बिल्ला
billaa	बिल्ला
bilhaur	बिल्हौर
bisva	बिस्व
biswa	बिस्व
bag	बाग
bikaner	बिकनेर
bikaneri	बिकनेरी
bk	बीके
beejak	बीजक
bijak	बीजक
beef	बीफ
beem	बीम
bim	बीम
beemon	बीमों
bimon	बीमों
beerganj	बीरगंज
birganj	बीरगंज
beesavaan	बीसवां
bisavan	बीसवां
bisawan	बीसवां
beast	बेस्ट
budvig	बुदविग
budwig	बुविग
bull	बुल
bulaao	बुलाओं
bulao	बुलाओं
bule	बुले
bulletin	बुलेटिन
brijesh	ब्रजजे
benvar	बेनवर
benwar	बेनवर
beaulad	बीलौद
bekaaboo	बेकाबू
bekabu	बेकबू
bechakar	बेचाकार
bechkar	बेचकर
bechate	बेचतत
bechte	बेचते
bediyan	बेड़ययंं
bethanal	बेठनाल
bethnal	बेथनाल
benis	बेनिस
belacha	बेलाचा
belcha	बेल्ाा
belinda	बेलिंदा
bevkufana	बेवकूफना
bewakoofaanaa	बेवकूफाना
bewkufana	बेडूकेनन
besahaaraa	बेसहरा
besahara	बेसहरा
basin	बसीन
besin	बेसिन
basil	बसील
besil	बेसिल
bandage	बंदगे
bandej	बंदेज
baithantey	बैठंतते
baithate	बैठतते
baitool	बैतूल
baitul	बैतूूल
betul	बेतुल
baini	बैनी
beni	बेनी
bairakpur	बैरकपूर
barrackpore	बैररककपोर
baila	बैला
bella	बेल्
ballistic	बाल्स्टिकिस
bells	बेल्स
bostan	बोस्टान
bosten	बोस्टन
boston	बोस्टन
bokaro	बोकरों
bodara	बोडरर
bodra	बोद्र
bodraa	बोदरा
bona	बोना
borkar	बोरकरा
borivali	बोरिवाली
boriwali	बोरिवाली
born	बॉर्न
bolane	बोलने
boliae	बोलिया
boliy	बोलिय
boliye	बोलिय
bosaan	बोसन
bosan	बोसन
bauni	बौनी
bouni	बोनी
byaawa	ब्यावा
byavar	ब्ववरर
brajesh	ब्रजेश
brijesh	ब्रजजे
brahmalin	ब्रह्माली
brahmleen	ब्रह्मलीन
brahmlin	ब्रह्मलिन
bravo	ब्रावो
brigatn	ब्रिगटन
brighton	ब्राइटन
brigton	ब्रिगटन
brigadier	ब्रिगाइडर
britain	ब्रिटेनन
breed	ब्रीद
brock	ब्रॉक
brok	ब्रोक
broke	ब्रोक
brocken	ब्रॉकेन
broken	ब्रोकेन
blosam	ब्लोसम
blossom	ब्लोसम
bhagaane	भगाने
bhagane	भागने
bhadakaaya	भड़काय
bhadakaya	भड़काय
bhadkaayaa	भड़काया
bhadkaya	भड़काय
bharakaaya	भड़काय
bharakaya	भड़काय
bhabhoot	भभभूत
bhabhut	भाभूत
bhay	भाय
bhaya	भाय
bhayo	भायो
bharatanatyam	भारतनाट्यम
bharatnatyam	भारतनाट्यम
bhartnatyam	भर्तनाट्यम
bharate	भराते
bharte	भरतत
bharani	भरणी
bharni	भरणी
bharane	भरने
bharne	भरने
bhara	भरा
bhavishya	भविष्य
bhaate	भाते
bhate	भाते
bhanu	भननु
bhabar	भाबर
bhareeye	भरीय
bhariy	भारिय
bhavanaon	भववनों
bhavnaon	भावनाओं
bhaskar	भससकर
bheed	भीद
bheera	भीरा
bhira	भीरा
bheesham	भीषम
bhisham	भिष्म
bhishm	भिष्म
bhugat	भुगत
bhugata	भूगता
bhugta	भुगता
bhutto	भुत्टो
bhumi	भूमि
bhurbhura	भूरभुर
bhookh	भूख
bhukh	भूख
bhookhi	भूखी
bhukhi	भूखी
bhoogol	भूगोल
bhugol	भूगोल
bhootal	भूताल
bhutal	भूताल
bhoopsingh	भूपसिंघ
bhupsingh	भूसपंंह
bhumi	भूमि
bhumika	भूमिका
bhulata	भुलाता
bhulataa	भुलतत
bhulta	भूलता
bhula	भुला
bhulaa	भुला
bhooli	भूली
bhuli	भूली
bhulo	भूलो
bhulon	भूलों
bhusi	भूसी
bhooswaami	भूस्वामी
bhusvami	भूस्वामी
bhuswami	भूस्वामी
bhengapan	भेनगापन
bhairavnath	भैरववाथ
bhairo	भैरो
bhogatey	भोगते
bhogte	भोगते
bhola	भोला
bholi	भोली
bholu	भोलू
bhaunho	भूनोहो
bhaunhon	भूनोों
bhoonhon	भूनों
bhraant	भरांत
bhrant	भरणंत
brant	ब्रंंट
bhraanti	भरांती
bhranti	भरणंति
branti	ब्रंटी
bhraantiyan	भ्रांतियां
bhrantiyan	भ्रंतियां
bhraantiyon	भ्रंतियों
bhrantiyon	भ्रंतियों
mangesh	मंगेश
manch	माचच
manchit	मानचित
mancheeye	मांछीय
manchiy	माचचीय
manchiya	मानचिय
manchon	मांचों
manjil	मंजील
manzil	मंजीलि
manjila	मंजीला
manzila	मंजीलला
manjilein	मंजीलें
manjilen	मंजीलें
manzilein	मंजिलें
manto	मंनो
mantriyon	मंत्रियों
makrani	मकररणी
maksad	मक्सद
makhdumpur	मख्मुपुर
machaaye	मचाए
machae	मचाई
machaye	मचाए
machaanon	मचानों
machanno	मचननों
machano	मचानो
machanon	मचानों
madaura	मदौरा
madhuara	मधुरा
madhura	मधूरा
manipal	मनीपाल
matpatron	मत्तप्रों
matthe	मट्ठे
matsyavatar	मत्स्ववततर
matsyavtar	मत्स्यवत्र
masyendranath	मस्यें््रनथ
matsyendranath	मत्स्नर्रननश
madhupur	मधुपरर
manmarji	मन्मररी
manae	मनाई
manaye	मन्य
mnaey	मने
mam	ममम
mum	मू्ू
maryokar	मर्योकार
mayorka	मयोरकक
mayorkaa	मयोरकक
mardaani	मर्दनी
mardani	मर्दनी
marmar	मर्मर
murmur	मूर्मर
maratha	मराााा
marathi	मारथी
marji	मर्जी
mardanagi	मर्दनागी
mardangi	मर्दंगी
mardo	मार्ो
mardon	मर्ोो
maryaadaa	मर्यादा
maryada	मर्ययदा
maryaadaaon	मर्यादाओं
maryadaon	मर्यदााों
malaga	मलगा
malaar	मलार
malar	मेलर
mashrak	मश्रक
masaaledaar	मसालेदार
masaledaar	मसलेेदर
masaledar	मसलेंदर
masoor	मसूर
masur	मसूर
masse	मसेस
mahakane	महाकने
mahakne	महाकने
mahkane	महककने
mehkane	महकाने
mahalon	महालों
mahlon	महललंं
mahagranth	महाग्रगा
mhagranth	महाग्रग
mahajan	महाजन
mhajan	महाजन
mahathir	महातिर
mhathir	महाथिर
mahanatam	महानतम
mahantam	महांतम
mhantam	महंततम
mahanideshak	महानिदेशक
mahanirdeshak	महानिर्दशक
mhanideshak	महानिदेशक
mahapauron	महापुरों
mhapauron	महापुरों
mahapran	महाप्रण
mhapran	महाप्रण
mahamantr	महांंत्र
mahamantra	महामंत्र
mhamantra	महामंत्र
maharaja	महाराज
mahavigyan	महाविज्ञान
mhavidyan	महाविज्ञान
mahavidya	महाविद्य
mhavidya	महाविद्य
mahavishnu	महाविष्णु
mahasingh	महासिंह
mahasinh	महासिंह
mahipal	महिपाल
mahin	महिन
mahinon	महिनों
maang	मांग
mang	मंग
mangani	मंगानी
mangni	मंगगी
maanga	मांगा
manga	मंगा
maangi	मांगी
mangi	मंगी
maange	मांगे
mange	मंगें
mango	मंगों
maori	मारी
maajin	माजिन
majin	मजीन
mathe	मठठे
mathey	मठठे
maap	माप
map	मेप
mop	मूप
mamooli	मामूली
mamuli	माूूली
mame	ममे
maarvaad	मारवाद
marvad	मर्वाद
marwar	मरवरर
maariya	मारिया
mariya	मरीय
maariyo	मारियो
mario	मररियो
mariyo	मररियो
martha	मर्थ
maalish	मालिश
malish	मालिश
mave	मेव
mavey	मावे
maas	मास
mas	मसस
mass	मस्स
maason	मासों
mason	मसों
mitaao	मिटाओं
mitao	मिटाओं
mithaai	मिथाई
mithai	मिथाई
media	मीडिया
mithila	मिथिला
mithilanchal	मिथिलांचल
mithya	मिथ्य
mimicry	माइमिक्र
milkiyat	मिलकियत
misha	मिशा
mungeri	मुंगरी
mundva	मुंडवा
mundwa	मुंडवे
munshiganj	मुश्शगंज
mukarte	मुकरते
mukartey	मुकरते
mukhopadhyaya	मुखोपाध्याय
mukhyopadhyaay	मुख्योपधययय
mukhyamantri	मुख्यमंत्री
munaf	मुनफ
munafa	मुनाफ़
munnu	मुनू
mufalisi	मुफलिसी
muflisi	मुफलिसी
mubarakpur	मूबरककपुर
mubarkpur	मूबारकपुर
murjha	मूर्झ
multae	मुल्ताए
multai	मुल्ताई
mushahid	मुशहिद
muhavare	मुहावरे
muhavre	मुहावरे
mooth	मूत
muth	मूत
mood	मूद
mud	मुद
moodi	मूदी
moody	मूद्य
mool	मूल
mul	मूल
moolchand	मूलचंद
mulchand	मूलचंद
moolar	मूलर
mular	मूलर
muller	म्लू
moolon	मूलों
mulon	मूलों
maxico	मैक्सिको
mexico	मैक्सिको
mega	मेगा
megapixal	मेग्प््कलल
megapixel	मेगपीस््ेल
mejbaan	मेबबान
mejban	मेबबान
mezbaan	मेबबान
mejabani	मेजबानी
mejbaani	मेबबानी
mejbani	मेबबानी
mezabani	मेज़बाी
mejbaan	मेबबान
mejban	मेबबान
mezbaan	मेबबान
mejbaani	मेबबानी
mejbani	मेबबानी
mezbaani	मेबबानी
mate	मटट
met	मीट
mates	मेटेस
medical	मेडिकल
methanol	मेथनोल
menu	मेनू
mem	मीम
melaghaat	मेलाघाट
melghat	मेघ्ाट
melaanin	मेलानिन
melanin	मेलानिन
melaani	मेलानी
melani	मेलानी
maheman	महेमान
mehamaan	मेहमान
mehaman	मेहमान
mehmaan	मेहमान
mehman	मेहमान
meharaam	मेहराम
mehram	मेहराम
macbook	मैकबुक
matix	मेट्टिक
matrix	मेट्रिक्स
mad	मद
made	मदड
maid	मीद
maddy	मद्य
maidi	मैदी
main	मिइन
man	मान
men	मेन
mainan	मैनान
menon	मेनों
manner	मेन्र
maina	मैना
maine	मेने
marrej	मररेज
marriage	मैरिज
merraige	मेरेज
maisachusets	मेशचसससेट
massachusetts	मेसचचुसेट्स
maisor	मैइोर
maisore	मैसोर
mysore	मैसूर
mod	मोड
mode	मोड़
modern	मोडर्न
module	मूडुल
modules	मॉडलल्स
modyuls	मॉडियल्स
mauritious	मॉरीशस
mauritius	मॉरीशसस
mogali	मोगली
mowgli	मूगलली
motive	मोटिव
mol	मोल
mold	मोल्ड
moshe	मोशे
mosad	मोसद
mohana	मोहना
mohani	मोहनी
mohini	मोहिनी
mohim	मोहिम
maukon	मौकों
mauma	मौमा
maurya	मौर्य
morya	मोरय
maurya	मौर्य
mauryon	मौर्यों
moryon	मोर्यो
maulaviyon	मौलवियों
maulvidon	मूलविदों
maulviyon	मौलवियों
maule	मोले
mauley	मॉली
mausa	मौसा
yatn	यतन्न
yatna	यतना
yada	यादा
yda	ईदा
yaduvansh	यदुवंश
yaduwansh	यदुवंश
jerusalem	जेरूसल
yarooshaleim	यरूश्लि
yarushalem	यशरशलल
yashpaal	याष्पल
yashpal	याष्पल
yaatna	यातना
yatna	यतना
yaatanaon	यातनाओं
yatnaon	यत्ानओं
yarayan	यारयन
yatraein	यात्राएं
yatraen	यात्राएं
yaariyan	यारियन
yariyan	यरियन
yaari	यारी
yari	यारी
yugam	युग्म
yugm	युग्म
yuddhrat	युद्धरात
yudhrat	युद्धात
ukrainian	यूक्रेनियन
ukranian	उक्रेनियन
jerusalem	जेरूसल
yorker	योर्के
yojanaein	योजनाएं
yojanaen	योजनाएं
yojanaye	योजनाय
rangate	रंगटे
rangte	रंगटे
rangkata	रंगकता
ranjkatha	रंजकता
ranjkta	रणजकता
raees	रीी
rais	ररस
raktaabh	रक्ताब
raktabh	रक्तभा
rakhna	रखना
raghupati	रघुपति
raghuram	रघुरम
registerd	रजजस्ट्र
registered	रेजस्ट्रेड
ratanpur	रतनपपपर
runners	रनर््स
rayan	रायन
ryan	र्यान
ralhan	रालहण
ravish	रविश
ravael	रवेल
ravel	रेवल
rawail	रवेली
rasad	रसदद
rasaayanik	रसायनिक
rasaayanika	रसायनिकक
rasayanika	रसायनिका
rasyanik	रास्यनिक
rasaayanon	रसायनों
rasayanon	रसायनों
rahamat	रहमात
rahmat	रहमत
rhamat	रहमात
rahenge	रहेंगे
rahegi	रहेगी
rounder	रुंदर
raak	राक
rak	रक
raakhe	राखे
rakhe	रखे
raagon	रागों
ragon	रगों
raghavan	रघवान
raaj	राज
raj	रज
rajkot	राजकोत
rajtantra	राजतंत्र
raajneetikaran	राजनीतिकरण
rajneetikaran	राजनीतिकरण
rajnitikaran	राजनीतिकरण
rajma	रजजमा
rajman	राजमान
raajasva	राजस्व
rajasva	राजस्व
raaji	राजी
raji	राजी
rajinaama	राजिनामा
rajinama	राजिनामा
raajon	राजों
rajon	राजों
rana	रण
raatrichar	रार्तिचार
ratrichar	रत्रिचार
raadhe	राध़
radhe	रदे
ranapur	रणनपपुर
rabin	रबीन
robin	रॉबिन
rabha	रभा
ramkot	रामकोट
ramkote	रामकोटे
ramtek	रामटेक
rampur	रामपुर
rambharose	रंभारोस
rambharosey	रंभारोसे
ramraj	रामराज
raalod	रालोद
ralaud	रालौद
ralod	रलोड़
ravaley	रवाले
ravle	रव्ले
rasayanik	रसायनिक
racreation	राक्रिएशन
recreation	रिक्रेशन
rig	रिग
riggs	रिग्स
rigs	रिग्स
richual	रिचुआल
ritual	रिटूयल
reduction	रेडिक्शन
ripan	रिपन
ripon	रिपों
ria	रिय
riya	रिया
rishte	रिश्टे
rishtey	रिश्टे
risane	रिसने
risaney	रसनेे
risne	रििन
rihana	रिहाा
rihanna	रिहन्न
regal	रगगाल
rigal	रिगल
reasonal	रिसोनल
regional	रेगिनॉल
retreate	रेट्रेटट
retweet	रेतववत
reeta	रीता
rita	रीता
rukate	रूकते
rukte	रुकते
ruktey	रुकते
rugan	ृग्ण
rugna	ृग्ण
ruganta	ृगंगत
rugnata	रूग्नता
rojvelt	रोजवेल्ट
roojwelt	रूजवेल््ट
roosevelt	रूजवेेल्ट
rodolph	रोडोल्फ
rudolf	रूडोल्फ
rudolph	रूडोल्फ
roopesh	रुपेे
rupesh	रुपेश
ruby	रूबी
roomani	रूमानी
rumani	ूममनी
rukavaton	रुकावटों
root	रूत
route	राउट
rooting	रूटिंग
routine	रोटिन
routing	रोटिंग
roots	रूत्स
routes	रूटेस
roopak	रुपक
rupak	रपपक
roopi	रूपी
rupi	रुपी
rantle	रंंटल
rental	रेंटलल
registan	रेजिस्टान
registani	रेजि््तानी
reja	रेजा
reza	रीज़
rate	राते
rate	राते
ret	रेट
refaeli	रेफैली
refeli	रेफेली
reshe	रेे
reshey	रेशे
race	रसस
rese	रीे
racer	रेसर
recer	रेसरर
racing	रेसिंग
reson	रसों
rehaana	रहहान
rehana	रेहना
racketeer	रेकेटिरी
racketier	रेकेटियर
rectare	रेक्टारे
radical	रेडिकल
raidical	रेडिक्
raith	रीठ
rapping	रपपिंग
wrapping	रापपिंग
robertsan	रॉबर्ट्सन
robertson	रॉबर्ट्नन
robinson	रॉबिंसन
royals	रोयाल्स
rojlin	रोजलिन
rozlyn	रोजलियन
rotation	रोटेशन
rodrigo	रोड्रिगो
ronaldo	रोनाल्डो
ronit	रोनिट
roni	रोनी
ropane	रोपने
ropaney	रोपने
ropne	रपपो
robin	रॉबिन
roya	रोय
rollers	रोलर्स
rovan	रोवन
rowan	रोनन
rosario	रोसरियो
rosariyo	रोसरियों
raubadaar	रौबदार
raubadar	रौबदर
raubdar	रौबद्र
landara	लंदरा
langada	लंगाड़ा
langda	लंंगड़ा
langar	लंगर
langaron	लंगारों
langron	लंंगरों
lambi	लंबी
lakeer	लकीीर
lakir	लककीर
lakiron	लककररों
lakme	लकमी
lakshmidhar	लक्ष्मीधार
lakshmighar	लक्ष्मीघर
lakshy	लक्ष्य
lakshya	लक्ष्य
lakshyon	लक्ष्यों
lux	ल्क
laksar	लक्सर
luxor	ल्क्सर
lakhkhi	लख्खी
lagna	लग्न
laganewale	लगनेवाले
lagnevaaley	लगनेवााल
lagnewale	लगेेनवाल
lagega	लगेगा
lajjalu	लजज्लु
latkate	लटकते
ladki	लड़की
ladate	लाड़ते
ladte	लड़ते
ladaai	लड़ाई
ladai	लड़ाई
ladaaiyon	लड़ाइयों
ladaeyon	लड़ाइयों
ladaiyon	लड़ाइयों
lapetane	लपेटने
lapetne	लपेटने
labada	लाबड़ा
lbada	लबड़ा
labdh	लाब्ध
lbdh	ल्ब्ध
lalak	लालक
lalkarata	लालकराता
lalkarta	लालकर्ता
lalla	लैला
lavasa	लावस
lovasa	लववासा
lassi	लससी
lahanaa	लहना
lahna	लहना
lehna	लेहना
lahraee	लहरायी
lahrai	लहराय
lehrayi	लहरायी
lahalhati	लहलहाटी
lahlahaati	लहलाहाती
lahlahati	लहलहााट
lahsun	लाहसून
lasoon	लेसन
lanchar	लांचर
launcher	लान्चर
lycopene	लाइकोपेन
lime	लिमे
lives	ल्वेस
live	लिव
laegi	लाएगी
lagataar	लगातार
lagatar	लगातार
laata	लाता
lata	लता
laati	लाती
lati	लेती
layega	लाएगगा
lalpur	लालपुर
las	लसस
last	लस्त
lindbhed	लिंदभेद
lingbhed	लिंग्ेद
lindan	लिंडनन
lindn	लिंडन
lindon	लिंडों
likhakar	लिखकर
likhkar	लिखकर
ligar	लाइगर
liger	लाइजर
liberation	लाइबरेेशन
libration	लाइब्रेशन
liberation	लाइबरेेशन
libration	लाइब्रेशन
leaderon	लीडरें
leedaron	लीदारों
lidaron	लिदारों
liidaron	लिइारों
louis	लुइस
luis	लियस
ludhakate	लुढ़कते
ludhkate	लुढ़कते
lurhakate	लुढ़कते
lutf	ल्ट
lumding	लुमडिंग
lootmaar	लूटमार
lootmar	लूटमार
landal	लंदल
lendal	लेंडाल
lega	लेगा
legaa	लेगा
letakar	लेटाकार
letkar	लेटकार
lenevali	लेनेवाली
lenewali	लेनेवाली
label	लेबलल
labeling	लेबेंगिंग
labelling	लेबेंगिंग
labelo	लेबेलो
labelon	लेबललो
lebalon	लेबलाोन
lemon	लीमोन
laingadan	लैंगाड़न
langdon	लंंगडन
lengdan	लेंगडान
laigikata	लैगिकटा
laingikta	लैंगिकता
lanset	लेंसेट
lenset	लेंसेट
lairi	लैरी
lairy	लैरी
larry	लैरी
lace	लेस
less	लेस
locket	लॉकेट
laundry	लांद््य
longewal	लोंगेवाल
longewala	लोंगेवाला
longoval	लोंगेवाल
log	लोग
loge	लोगे
lochdar	लोचदार
lodi	लोडी
laurence	लारेंस
laurens	लॉरेंस
laurense	लारेंस
wonder	वंडर
vansh	वंश
vanshdhar	वंशधधर
vanshavad	वंशावाद
vanshvaad	वंश्वाद
vanshvad	वंश्वाद
wanshwad	वंश्वाद
vajood	वजूद
vajud	वजुदद
wajood	वजूद
vadali	वदाी
vadli	वदली
wadali	वदली
vanita	वनीता
vareinye	वरीनन
varenya	वर्नीय
varn	वर्न
varna	वर्ण
varnit	वर्निट
vartamaan	वर्तमान
vartaman	वर्तमान
vartmaan	वर्तमान
vartman	वर्तमान
varddhaman	वर्द्ामन
vardhmaan	वर्धमान
vardhman	वर्धमान
verbal	वर्बल
varshan	रर्शन
vasharan	वशरर
vershan	वर्शन
version	वर्जिन
varsaache	रर्साच
varsaryache	वर्साायचक
vasearche	वस्ररक
valkan	वालककन
valkkan	वालककन
velkan	वेलकनन
vash	वर्
vashikaran	वाषीपीरण
vaangchuk	वांछूक
vangchuk	वंंछुक
wangchuk	वंंछकक
want	वंट
vije	विजे
vise	विसी
wise	विज
vatar	वतार
water	वेटर
watson	वत्ससं
wattson	वत्तससं
vaan	वन
waan	वन
vaanon	वनों
vanon	वनों
wanon	वनों
vatanukulan	वातानुकूनन
watanukoollan	वातानुकूलन
vaadak	वदद
vadak	वदक
vaadiyon	वाडियों
vadiyon	वदियों
wadiyon	वदियों
vayana	वायना
vayna	वायना
wayna	वायना
wireless	वेयरलेस
wirerless	वायर्लेज
warrior	वारियर
warriors	वारियर
valve	वाल्व
wolv	वो्व
vastavik	वास्ताविक
vastvik	वास्त्विक
vaahikayen	वाहिकाएं
vahikayen	वाहिकाएं
wahikayan	वाहिकाएं
winter	विंटर
vincent	विंसेंट
vikalpon	विकल्पों
wicket	विक्ट
vikramjeet	विक्रमजजित
vikramjit	विक्रमजित
vichaarakon	विचारकों
vicharakon	विचारकों
vigyan	विज्ञान
vigyaani	विज्ञानी
vigyani	विज्ञानी
vigyaanon	विज्ञानों
vigyanon	विज्ञानों
vitthal	विथ्थल
viththal	विथथल
vitthal	विथ्थल
vitark	वितरकक
vidhaaein	विधाएं
vidyaayein	विद्याएं
vidyaen	विद्याएं
vidhaaon	विधाओं
vidyaaon	विद्याओं
vidyaon	विद्याओं
vidhansabhaein	विधानसभाएं
vidhansabhaen	विधानसभाएं
vidhivat	विधिवत
vidhut	विद्युत
vinasht	विनाश्ट
vineet	विनीत
vinit	विनिट
vipreetataa	विप्रीतता
vipritata	विपरितता
vipra	विप्र
vipro	ििपरो
wipro	ििपर
vibha	विभा
vibhajak	विभाजक
vibhram	विभ्रम
vibhrm	विभर्म
vibram	वाइब्रम
vimarsh	विमर्ष
vimarsho	विमर्शो
vimarshon	विमर्शों
virajati	विराजती
virechan	विरेचन
virodh	विरोध
virodhabhasi	विरोधाभससी
virodhabhason	विरोधाभससं
vividh	विविध
vivekahin	विवेकाहीन
vivekheen	विवेखीन
visheshan	विशेषण
visheshanon	विशेषनों
visheshaadhikaar	विशेषाधिकार
visheshadhikar	विशेषाधिकार
vishwasaniy	विश्वसनीय
vishwasniiya	विश्वस्ीयय
vishwasaniyata	विश्वससनययता
vishwasniiyataa	विश्वस्नीयता
vishahin	विशहीन
vishhin	विशिण
vishanu	विषाणु
vishnu	विष्णु
vlc	व्लस
weeks	विक्स
veerchand	वीरचंड
virchand	विरचंद
veeresh	वीरेश
viresh	विरेश
vritton	वृत्टों
vruton	वर्तों
vrutton	वर्तों
venkataraman	वेंकटरमण
venkatraman	वेंकटरमम
ved	विद
wade	वदे
wed	विद
wedding	वेडिंग
vediyon	वेडियों
vedon	विदों
venezuela	वेंजीयलल
veronica	वरोोनिक
veronika	वेरोनिका
weronika	वेरोनिका
velvet	वेलवेट
welwet	वेलववेट
welder	वेल्डर
weldor	वेल्डर
welding	वेल्डिंग
wealth	वील्थ
vellur	वेल्यर
velur	वेलर
vesh	विष
wasting	वसस्टिंग
westing	वेस्टिंग
wastinghouse	वास्टिंहसस
westinghouse	वेस्टिंहसस
vaisley	वैसले
vesle	वेसलल
wesle	वेसल
vaigyaanik	वैज्ञानिक
vaigyanik	वैज्ञानिक
vegyanik	वैज्ञानिक
vaigyaanikta	वैज्ञानिकता
vaigyanikata	वैग्ञानिकता
vaigyanikta	वैज्ञानिकता
vaitravati	वैत्रवाती
vaitrawati	वैत्रवाती
vaimanasy	वैमानस्य
vaimanasya	वैमानस्य
vaimanya	वैमान्य
very	वररी
vaisaakh	वैसाख
vaishakh	वैशाख
vaishaakhi	वैशाखी
vaishakhi	वैशाखी
vaishnodevi	वैश्नोद्वी
vyaktigat	व्यक्तिगत
vyagr	व्यगग्र
vyagra	व्याग्रा
vyatit	व्यतित
vytit	व्यिति
vyabhichar	व्यभभचचर
vyabhichari	व्यभभिकारी
vyavadhan	व्यवधान
vyavdhan	व्यवधान
vyavahargat	व्यवह्रगत
vyvhargat	व्ववह्रका
vyaghat	व्याघात
vyapak	व्यापक
vlad	व्लाद
wlaad	वलाद
vladimir	व्लेदिमीर
shanghai	शंघाई
shatpath	शटटपठ
shanivar	शानिवर
shaniwar	शानीवार
shabana	शबनना
shbana	शबान
shabdarth	शब्दर्थ
shamadan	शामाान
shmadan	श्माान
shamitabh	शमीताभ
shamil	शमीिल
shmil	श्मिल
sharabon	शराबों
shrabon	श्रबों
shararat	शराात
shrart	शरारत
sharmana	शर्मना
shaharwasiyon	शहर्वससयों
shahrvasiyon	शहर्वससयों
shervasiyon	शेरवासियों
shahdara	शाहदरा
shaantikaal	शांतिकाल
shantikal	शांतिकाल
shaao	शाओं
shao	शाओं
shaakir	शाकीर
shakir	शकीरर
shaakhaaen	शाखाएं
shakhayan	शखखाां
shakhayen	शाखाएं
shayak	शायक
shaavakon	शावकों
shavakon	शावकों
shavkon	शावकों
shaasaka	शासका
shasak	शासक
sasakon	सससकों
shaasakon	शासकों
shasakon	शासकों
shipra	शिप्र
shirke	शिरके
sheershakon	शीर्षकों
shirshakon	शिर्षकों
shirshkon	शिर्षकों
shujaat	शुजात
shujat	शुजात
shooting	शूटिंग
shutting	शटटटिंग
should	शोल्ड
shud	शुद
shubhankar	शुभंकर
shumaali	शुमाली
shumali	शुमाली
shringaar	श्रृंगार
shringar	श्रृंगार
shrungar	श्रृंगर
sheling	शेलिंग
shelling	शेलिंग
shaili	शैली
shaly	शल्य
sheli	शेली
shaishav	शाश्व
sean	सीन
shaun	शौरो
shawn	श्वन
short	शोर्ट
sure	सुरे
shrankhala	श्रृंखला
shrankhalaa	श्रृंखला
shrunkhla	शृंखला
shrankhalaaon	श्रखंखओाओं
shrinkhalaon	श्रृंखलाओं
shrunkhlaon	शृंखलाओं
shravani	श्रवानी
shrikar	श्रीकार
shrikhand	श्रीखंड
shrimati	श्रीमती
shriram	श्रीरम
sriram	श्रीरम
shrotaon	श्रोताओं
shat	श्ट
sankhyaein	संख्याएं
sankhyaen	संख्याएं
sankhyayen	संख्याएं
sanghanit	संघानित
sanghnit	संघनीत
sanchayan	संचायं
sanchar	संचार
sanchaari	संचारी
sanchari	संचारी
sanchalanon	संचाननों
sanchalnon	संचाननों
sanjay	संजय
sanjeevan	संजीवन
sanjivan	संजीवन
santati	संतती
sandarbh	संदर्भ
sandarbha	संदर्भ
sandrbh	संद्रभ
sandarbhon	संदर्भों
sandrbhon	संदर्भों
sandali	संदली
sandli	सांडली
sandhan	संधान
samprati	संपररति
samprti	संपर्ति
samprabhu	संप्रभू
samprbhu	संप्रभू
samprabhuta	संप्रभूता
samprbhuta	संप्रभुता
sambit	संबित
sambhalane	संभालने
sambhalne	संभालने
sambhrant	संभररंत
sanbharnt	संभरंत
sanyog	संयोग
sanyukt	संययुक्त
sanyukta	संयुक्त
sanyukta	संयुक्त
sanyogvash	संयोग्वश
sanyojan	संयोजन
sanyojanon	संयोजनों
sanyojnon	संयोजनों
samvedikaran	संवेदीकरण
sanvedikaran	संवेदीकरण
samshayon	सम्ययों
sanshayon	संशयों
sanshyon	संश्यों
sanskaar	संस्कार
sanskar	संस्कार
sanskaari	संस्कारी
sanskari	संस्कारी
sanskrit	संस्कृत
sanskurt	संस्कृत
sanskritiyan	संस्तुतियां
sanskrutiyan	संस्तुतियां
sanskritiyon	संस्त्तियों
sanskrutiyon	संस्तृतियों
sanasthit	सानस्थित
sansthit	संस्थित
sanasthita	सानस्थित
sansthita	संस्थिता
sakara	सकरा
sakra	सक्र
sakshan	सक्षण
suction	सक्शन
sacchidanand	सच्चीदांद
sachhidanand	सचिदादंद
sachidanand	सचिदानंद
sajja	सज्जा
sat	स्त
satpal	सप्ताल
satluj	सतलूज
sataane	सताने
satane	सतने
sate	सते
satti	सत्ती
satvat	सत्वत
sadanand	सदननंद
sapane	सपान
sapne	सपने
sapney	सपने
saparivaar	सपरिवार
sapariwar	सप्रवायर
sparivar	स्परिवार
sapaat	सपाट
sapat	सपट
sapate	सपाट
sapatey	सपटे
saptakranti	सप्तक्रांति
saptkraanti	सप्तकरराति
saptapadi	सप्तापदी
saptpadi	सप्पप्दी
saptari	सप्टारी
sapramaan	सप्रमान
sapraman	सप्रमाण
submit	सबमिि
sabmission	सब्मिशन
submission	सबिमिशन
sabhaein	सभाएं
sabhaen	सभाएं
sabhayen	सभाएं
sabhen	सभें
sabhasadon	सभासदों
sabhyata	सभ्यता
samjhoonga	समझूंगा
samjhunga	समझूंगा
samjhungaa	समझूंगा
saman	सामन
samanvayaka	समन्वयकक
samanwayaka	समन्वय्क
samnvyak	समन्वयक
samaadhaan	समाधन
samadhan	समाधन
samadhiyon	समाधियों
samadjiyon	सम्दजीयों
samalakha	समलाखा
samalakhaa	समलाखा
samahaar	समहार
samahar	समहहर
samitiyan	समित्यां
sametati	समेटटी
sametti	समेटटी
sarka	सरका
sarkaa	सरका
sarkarein	सरकारें
sarkaren	सरकररें
sarkaaron	सरकारों
sarkaron	सर्करों
sargana	सर्गना
sarganaon	सरगगानओं
sargi	सर्गी
sarguja	सरगुजा
sarjuga	सर्ूगा
sarsa	सरसा
sarsaa	सरसा
sarahind	सरहहंद
sarhind	सरहंंद
sirhind	सिरहंद
saraaha	सराहा
saraha	सराह
saraahi	सराही
sarahi	सररह
salaahkar	सलाहकर
salahkaar	सलहाकार
salahkar	सलहाकार
saleeb	सलीबी
salib	सलीब
select	सेलेक्ट
saltanat	सल्टनाट
saltnat	साल्टेेट
savaal	सवाल
saval	सववल
sawaal	सवाल
sawal	सवाल
sahakalaakar	सहकालकार
sahakalakar	सहकालकर
sahkalakar	सहकालकर
sahadev	सहादेव
sahdev	साहेवव
sahrawat	सहरावत
sherawat	शेरावत
sahooliyata	सहूलियता
sahuliyat	सहूलियत
sahuuliyata	सहूलियता
saanketika	सांकेटिका
sanketik	संकेटिक
saimans	सैमंंस
simmons	सिममंस
symons	सायमंस
saima	सैमा
sagarika	सगरीकका
sagrika	सग्रीका
saga	सगग
saajan	साजन
sajan	सजन
saajsajja	साजसजज
sajsajja	सजसजजज
saja	सजा
saathsaath	साठ्साथ
sathsath	सठास्थ
sathiya	सथिय
saabah	साबह
sabah	सबाह
samanjasy	समंंज्य
samanjasya	समंंज्य
samoa	समो
samoaa	समोओ
saayn	सायन
sayan	सायन
saym	स्यम
saira	सैरा
sayara	सायरा
sayra	सार्
salve	साल्व
sahab	सहाब
singapore	सिंगपपोर
singaar	सिंगार
singar	सिंगर
singer	सिंगर
singhaadey	सिंघाड़े
singhade	सिंहडड़
singhde	सिंहदे
singhre	सिंघरे
singhi	सिंही
singha	सिंहा
sinha	सिन्हा
siera	सिएरा
sierra	सियरा
sikud	सिकुद
signals	सिगननल्स
cigaretton	सिगरेेटन
cigretton	सिग्रेटन
siddhivat	सिद्धिवत
siddhvat	सिद्धवत
siddhwat	सिद्धवत
sinabang	सिनबांग
synapse	स्नायप्स
sipah	सिपाह
sipaha	सिपहह
sipahiyon	सिपहियों
sipahi	सीपहह
sim	सिम
simat	सीमाट
simatataa	सीमटता
simatta	सिमात्ता
simtata	सिमटता
simtataa	सिमटता
cement	सीमेंट
simate	सीमटे
simi	सिमी
simmy	सिम्म
sims	सिमस
siyasi	सियासी
siyah	सियाह
siyaha	सियाहा
sirpur	सीरपुर
sivan	सिवन
siwan	सिवान
sisva	सिस्व
siswa	सिस्व
cil	सील
csi	सीएी
sikar	सिकार
seaten	सीटन
sitaram	सीतारम
sitaharan	सीतारणण
cpm	सीपीएम
cps	सीपी
cbse	स्बेस
seem	सीम
sim	सिम
sealed	सीलेड
shield	शिल्ड
ccd	सीसी
sugamata	सुगममा
sugmta	सुगमतता
sujan	सूजन
sujen	सुजें
suken	सुकें
sujain	सुजेनन
sujhaati	सुझाती
sujhati	सुझाती
sutali	सुतली
sutli	सुतली
suta	सूता
sdueep	स्वीप
sudip	सुदिप
sudhaargrah	सुधार्गरह
sudhargrih	सुधारगररह
sudhargruh	सुधारगररह
sunaaron	सुनारों
sunaron	सुनारों
sunaseer	सुनासिर
sunasir	सुनासिर
suneeti	सुनीती
suniti	सुनिती
sunega	सुनेगा
suneyga	सुनेएग
superhit	सुपरहहित
supachy	सुपच्य
supachya	सुपच्य
supachye	सुपच्य
subhaay	सुभाय
subhay	सुभाय
surveen	सुरवीन
survin	सुरविन
surana	सुराना
sulkhan	सुलखणन
suljaayi	सुलझाई
suljayi	सुलझाई
suljhai	सुलझाई
sulzai	सुलझाई
sultana	सुल्ताना
sulaati	सुलाती
sulati	सुलाती
susanskrit	सुसंस्कृत
susanskrut	सुसंस्कृत
suhagin	सुहागिन
soond	पूंड
sund	संं
suiyan	सूयन
sukhati	सुखती
sukhti	सुखती
sukhakar	सुखाकार
soochak	सूचक
suchak	सुचा
sooja	सूजा
suja	सुजा
suba	सुबा
sube	सुबे
sooraj	सूरज
suraj	सुरज
surinaam	सुरिणाम
surinama	सुरीणामा
suriname	सुरिनाम
suryadev	सूर्यदेव
sendha	सेंधा
senvai	सेनवाई
sevai	सेवाई
sensing	सेंसिंग
sexual	सेक्सुल
saturday	सतुर्दय
seti	सीती
seto	सीटो
seth	सीठ
safety	सेे््ट
semen	सिमें
semin	सेमिन
self	सेल्फ
selfie	सेल्फी
save	सावे
sev	सेव
sevakon	सेवकों
sevkon	सेवकों
samuels	समुल््स
celery	सेलरी
salary	सैलरी
sakar	साकार
socar	सोकार
soccer	सोस्सर
songs	सोंगस
solicitor	सललीसिटर
sochane	सोचने
sochne	सोचने
sonu	सोनू
soma	सोमा
spma	स्पाम
somi	समम
soy	सो
soya	सोया
solitaire	सोलीटायर
soharai	सोहराई
sohrai	सोहराई
sohaval	सोहावल
sohawal	सोहवाल
saunpane	सौनपपन
sonpne	सनपपन
scala	स्केला
skala	स्कला
ski	स्की
scootaron	स्कूटरों
scooteron	स्कूटरों
skootaron	स्कूटरों
scandinavia	स्केंडीनिया
scaining	स्केनिंग
scanning	स्केनिंग
squash	स्क्वाश
squash	स्क्वाश
skhalan	स्खलन
stain	स्टेन
stan	स्टनन
stop	स्टोप
stops	स्टोप
stone	स्टोन
straws	स्ट्रॉस
stress	स्ट्रेस
stra	स्ट्रा
stray	स्त्रा
stre	स्ट्रे
strocks	स्ट्रॉक्स
strokes	स्ट्रोक्स
stan	स्टनन
stanadhari	स्तनधारी
standhaari	स्तनधारी
standhari	स्तनधारी
sthiti	स्थिति
stithi	स्तिथि
stuti	स्टूटि
sthitiyaan	स्थितियां
sthitiyan	स्थितियां
sthitiyon	स्थितियों
sthool	स्थूल
sthul	स्थूल
sthoolta	स्थूलता
sthulata	स्थललता
sneakers	स्नीकर्स
snickers	स्निकर्स
snikarse	स्नीकर्स
spear	स्पीयर
spell	स्पेल
spelar	स्पेलर
speller	स्पेलर
sprint	स्प्रिनट
sprit	स्प्रिट
spray	स्प्राय
spry	स्प्री
sfoorti	स्फोर्ति
sfurti	स्फूर्ति
sphoorti	स्फूर्ति
slide	स्लाइड
slider	स्लाइडर
slaaidon	स्लाइडों
slidon	स्लीडोन
sliders	स्लाइडर्स
slides	स्लीडेस
slice	स्लाइस
slash	स्लाश
swaroopon	स्वरूपों
swarupon	स्वरूपों
swa	स्वा
swaachaalit	स्वचालित
swachalit	स्वचालित
swaarthparak	स्वर्थथ्रक
swarthparak	स्वर्थपथरक
swiftlate	स्विफ्टलेट
swiftlet	स्विफ्टेेट
sweekarte	स्वीकारते
swikarte	स्वीकारते
sweet	स्वीत
sweep	स्विप
sweccha	स्वीच्छा
swecha	स्वीच्
swechha	स्वेच्छा
sweta	स्वीता
swap	स्वर
swipe	स्विप
handiya	हंंियया
handiyaa	हंंिया
hundiya	हंदिय
hakikat	हकिकत
haqeeqat	हकीकत
hathiya	हठिया
hamala	हमला
hamla	हमला
hamalavar	हमलावर
hamlavar	हमलावव
humlavar	ह्ललावर
hamaal	हमाल
hamal	हमाल
hercules	हर्कूल्स
hardas	हरदास
harpaal	हरपपाल
harpal	हरपपल
harvansh	हवववंश
haraval	हरवाल
harawal	हरावल
hurricane	हारीकन
harijan	हरिजन
hariyali	हरियाली
harshit	हर्िित
haldi	हालडडी
halla	हल्ला
hawamahal	हवामहलल
hawalaat	हवालात
hawalat	हवालात
hasino	हेसिोो
hasinon	हसीनों
haan	हान
han	हनन
haanfte	हांफते
hafate	हाफते
hanfte	हांफते
higman	हाइग्न
hymen	हायमें
hadauti	हडौती
haani	हानी
hani	हनी
haarjeet	हार्जित
harjeet	हरजीत
haaranaa	हारणा
harana	हराना
harna	हर्ण
haalchaal	हालचाल
haalchal	हालचाल
halchaal	हलचलाल
halchal	हलचल
halt	हाट्ट
hault	हाल्ट
hahakar	हहककर
hingis	हींगिस
hindan	हिंदन
hindon	हिंदों
hijada	हिजड़ा
hijda	हिज्दा
hijbul	हिजबुल
hippo	हिप्
hippopotamus	हिपोपोटाममस
himali	हिमाली
hilane	हिलने
hilne	हिलने
hisham	हिशम
heeraganj	हीरगगंज
hiraganj	हीरगंज
heroes	हीरोज
heros	हेरोस
hui	हूई
huin	हूइन
hooper	हूपर
huppar	हुपप
hupper	हुपरर
hegde	हेग्े
hemvati	हेमवाती
hemwati	हेमवाती
help	हेल्प
helper	हेल्पर
haito	हैटो
hairam	हैराम
harem	हारम
herald	हेरॉल्ड
haive	हैवे
have	हेवे
hong	होंग
half	हाल्फ
hoaf	हाफ
hounga	हाउंगा
holding	होल्डिंग
hoshangabaad	होसनगाबा़
hoshangabad	होसनगाबड़ा
hostes	होस्टेस
hostess	होस्टेस
