ank	आंक
anka	आंका
ankit	अंकित
anakon	अंकों
ankhon	अंखों
ankon	अंकों
angkor	ंंगकर
ankor	आंकोर
angaarak	अंगारक
angarak	अंगरक
angraji	अंग्रजी
angreji	अगग्रजज
angrzi	अंगर्जी
antah	अंतः
antaha	अंतःा
antarmukh	अंतरमुख
antmurkh	अंतमुर्ख
antrmukh	अंतरमुख
andrabee	अंदराबी
andrabi	अंदराबी
andha	अंधा
andhapan	आंधापन
andheri	अंधेरी
ambaani	अमबानी
ambani	अमबानी
akram	अक्रम
acapulco	एकापुल्को
akapulko	अपापुलकों
akhand	अखंड
akhil	अखिल
agavai	अगवाई
agvaai	अग्वाई
augustine	अगस्टिन
augustustine	अगस्टस्टिनन
agsta	अगस्ता
agusta	अगुस्ता
augusta	औगसता
agr	गग्र
agra	अग्र
achambha	अचंभा
achanbha	अचंभा
achievement	ऑचिवेमेंट
achivement	ऑकिवेमेंट
acchi	चि्छी
achchi	चच्छी
achhi	अछिछी
achyut	छछ्तु
achhanera	अच्नेरा
achnera	अचेनरा
ajmeedh	अजमीध
ajhar	आझर
azhar	आझार
ajit	अजीत
agnat	अग्ञतत
agyaat	अज्ञात
agyat	अज्ञत
atakta	आतकता
atkata	आटकता
atake	अटके
atke	टके
atwaal	अटवाल
atwal	अटवाल
attahasa	तत्हासाा
atthaas	अत्तास
atthas	अत्थास
addon	डडडो
athak	अथकक
atharv	अथर्व
atharva	अठररवा
adad	ददद
adaani	अदानि
adani	अदानि
advait	अववैत
adwait	अववेत
advaitvaad	अद्वैतवाद
advaitwad	एद्वैतवाद
adhivas	अधिवास
adhiwas	अधिवास
advivas	ददविवस
adhiik	आधिक
adhik	आधिक
adhyayanarat	अध्ययनरतत
adhyayanrat	अध्ययन्ात
adhyaynrat	अध्ययन्रत
anant	अनंत
ananti	अनंती
angadh	अंगद्ध
angarh	अंगरह
anchahe	अंचाहे
anthak	अंठक
unthak	उंठक
anhoni	अन्होनि
anaavashyak	अनावश्कक
anavashyak	अनावश्कक
anavshyak	अनावश्यक
anawashyak	अनवाश्कक
anik	अनिक
anishwarvadi	अनिश्वरववादी
anishwarwadi	अनिश्वरववादी
anukoltha	अनुकोल्था
anukulata	अनुकुलता
anukulta	अनुकुलता
anuchit	अनुचिति
anuprayogi	अनुप्रयोगी
anuprayogon	अनुप्रयोगों
anupryogon	अनुप्रयोगों
anureet	अनुरीत
anurit	अनुरित
anuthi	अनुठी
anudit	अनुडित
anyaay	अन्याय
anyay	अन्ययय
anyaya	अन्याय
apnani	अपनानी
aparivartanshali	अपरिवर्तनशाली
aparivartansheel	अपरिवर्तनशील
aparivartanshil	अपरिवर्तनशील
apariharya	अपरियार्य
aprihary	अपरियार्य
apriyary	अप्रियार्य
apavartit	अपवर्तित
apvartit	अपवर्तित
apvtrit	अपवत्रित
apaardarshi	अपारदर्शी
apardarshi	अपररदर्शी
afroj	अफ्रज
afroz	फफरोज
africa	अफ्रिका
abbaasi	अब्ाासी
abbasi	अब्बासी
abhimat	अभिमत
abhishap	अभिष्प
abhi	अभि
amjhera	अमझेरा
amzera	अमजेरा
amargad	आमरगद़
amargarh	आमरगगढ़
amarpaal	अमरपाल
amarpal	अमरपाल
amarohi	अमरोही
amrohi	अमरोही
amaanat	अमानत
amanat	अमानत
amanth	अमांत
amaanati	अमानती
amanathi	अमानाथी
amanati	अमानती
amavasya	अमावस्य
amavsya	अमावस्या
amit	अमित
amitao	अमिताओं
amitav	अमितवव
amuk	आमूक
amogh	अमोघ
ambani	अमबानी
ayodhyaanaath	अयोद्यानाथ
ayodhyanaath	अयोद्यनाथ
ayodhyanath	अयोद्यनाथ
ayodhyeanath	अयोद्यनन
aradas	अरदास
ardaas	अरदास
ardas	अरदास
arabab	अरबब
arbab	अरबब
around	राोंद
arjent	आर्जेंट
urgent	र्जेें
arth	आर्थ
artha	अर्था
earth	इर्थ
earthquake	इर्थक्कक
arthon	आर्थों
arpit	आर्पित
aryama	अर्यामा
aryma	अरिमा
arymaa	आरिमा
alankaar	अलंकार
alankar	आलंकर
alnkaar	अलंकार
alankaaron	अलंकारों
alankaron	अलंकारों
alnkaaron	अलंकारों
alnkaron	अलंकारों
alagavavadi	अलगववादी
algavvadi	अलगववादी
algavwaadi	अलगववादी
alive	एलीव
alance	ललांस
alayans	ललयंस
aliance	लाययंसस
alind	अलिंद
alai	ललाई
ali	लली
alii	लली
alonso	आलोंसों
aloso	आलोसो
alphabet	अल्फाबेट
alba	अल्बा
avantipur	अवंतिपुर
awantipora	अवंतिपपरर
avaru	अवरु
avru	अवृु
awaru	अवारु
avarodhak	अवरोधक
avrodhak	अवरोधक
avrodhk	अवरोधक
avarnata	आवर्णता
avarnataa	आवर्णता
avranta	अवरंता
avashist	अवशिष्ट
avshisht	अवशिष्ट
awashist	अवाशिस्त
avasthaayen	अवस्थाएं
avsthaen	अवस्थाएं
avsthayen	अवस्थाएं
awasthaen	अवस्थाएं
avi	अवी
avika	अविका
aviral	एवाराल
avirl	एवर्ल
avishvaasniy	अविश्वासनीय
avishvasniy	अविश्वासनीय
avishvasniya	अविश्वा्नीय
avisvasniya	अविस्वासनीय
aviva	अविवा
avaigyanic	अवैज्ञानिक
avaigyanik	अवैज्ञनिक
avegyanik	आवेज्ञानिक
ashaktataa	आशक्तता
ashktta	अष्कता
asharaphi	आशाराफी
ashrafi	अशरफफी
ashariri	आशररीीी
ashriri	शश्रीरी
ashrvatath	आश्रवतात
ashvtth	अश्वत्था
asamaany	असामान्य
asamany	असामान्य
asmanye	असमान्य
asaamnjsy	असांंज्य
asamanjasy	असमंजस्य
asamanjasya	असमंजस्या
asurakshit	असुरक्षित
asurkshit	असुरक्षित
aset	एसे
asset	एसेट
asvabhavik	अस्वाभाविक
aswabhavik	अस्वाभाविक
aswbhavik	अस्वभाविक
ahirauli	अहिरौली
item	इतेम
items	टेटमम
idle	इडडल
idol	इडोल
icc	आईसीसी
iso	ईसोओ
ipc	आिपीसी
ipad	पिपद
iris	इरिस
ounce	आउंस
aakaash	आकाश
aakash	आकाश
aake	आके
aakhet	आखेत
akhet	अखेत
aagat	आगत
aagaman	आगमन
aagman	आग्मन
aagaa	आगा
aagah	आगाह
agha	घघा
aagaashe	आगाशे
aagashe	आग्शे
agashe	अग्शे
aajmaanaa	आजमाना
aajmana	आजमाना
aazmaanaa	आजमाना
aata	आता
ata	ता
atta	अत्ता
aatmayen	आत्मएं
atmaen	आत्मां
aadaan	आदान
aadan	आदन
aadhaarit	आधारित
aadharit	आधारित
adharit	आधारित
aadheen	आधीन
aadhin	आधिन
aadhunik	आधुनिक
aanad	आनदद
aanand	आनंद
anand	आनंद
aapka	आपका
aapkaa	आपका
aapadaaaen	आपदाएं
aapdaein	आपदाएं
aapdayein	आपदाएं
aabantit	आबंतित
abantit	अबंतित
aabru	आब्रु
abaru	अबारु
aamdan	आमदान
amadan	आमदन
aamdani	आमदनिी
amadani	अमदानी
aamdi	आमदी
amdi	आमदी
aamod	आमोद
amod	अमोद
aayenge	आयंंे
aayojak	आयोजक
ro	रो
rp	ऋऑऑऋऔऑऑऑऊऊऊऊऊऊऊऊऊऊऊढढढढऔढढढऔढढ
aaraam	आराम
aaram	आरम
aram	अरम
aarushi	आरुषी
arushi	अरुषि
artery	आर्टरीी
order	ऑर्डर
aary	आर्य
aarya	आर्य
arya	आर्या
aaryika	आर्यिका
aryika	आर्यिका
aarya	आर्य
arya	आर्या
aryo	अरियो
aaryan	आर्यण
arya	आर्या
aryon	आरययो
aalsi	आलसी
alasi	ललसी
aalochak	आलोचक
alochak	ललोचक
aalochakon	आलोचकों
alochakon	आलोचकों
aalha	आल्हा
aalhaa	आल्हा
alha	अल्हा
allah	अल्लाह
aawaazen	आवाजें
aawajen	आवाजें
awaazen	आवाजें
awazen	आवाजें
aawajon	आवाजों
aawazon	आवाजों
awaazon	आवाजों
awazon	आवाजों
aavishakaar	आविषाकार
aavishkaar	आविष्कार
avishkar	आविष्कार
aavriti	आवृति
aavritti	आवृत्ति
avuti	अवूती
aavritiyon	आवृतियों
aavrittiyon	आवृत्तियों
avrutiyon	अवृतियों
aashanka	आशंका
ashanka	आशंका
aashriton	आश्रितों
ashriton	आश्रितों
aasaan	आसान
aasan	आसन
asan	असं
aastik	आस्तिक
astik	आस्तिक
aasteen	आस्तिन
aastin	आस्तिन
astin	अस्तिन
aahnaan	आहनान
aahnan	आहनन
ahyan	आह्वान
england	इग्ल्लैड
engineer	इंजीनियर
introduction	इंट्रोडक्शन
insurance	इनसररेसस
ear	ईर
eyer	ईर
eon	योन
iaan	ईनां
ekattha	इकट्ठा
ikattha	इकठ्ठा
ekatthi	इकट्ठी
ekthi	इक््ठि
ikatthi	इकट्ठी
ekaee	एकाी
ikai	ईकाई
ekaeyon	इकाइयों
ikaiyon	ईकाईयों
ikarion	ईकारियों
economic	इकोनोमिककक
ecuador	ईक्यूडरर
equador	इक्वूडरर
equities	एक्विटीज
ikvitija	इक्वितीजा
ijaajat	इज़ाजत
ijajat	इज़जात
inhalation	इनहाेशनन
inhaletion	इनहेेशनन
ibija	इबिजा
ibiza	इबिजााा
imaging	इमगेंग
immune	मम्यून
elaichi	इलेची
ilaichi	इलाईची
ilayachi	इलायाची
ilayichi	इलायचिी
elaaj	इलाज
ilaaj	इलाज
ilaj	इलाज़
ishaak	इश्क
ishaaq	इशाक
ishak	इश्क
ishaara	इशारा
ishaaraa	इशारा
ishara	इशारा
ishita	इशिता
isht	इष्ट्
isteefe	इस्टीफ
istife	इस्टाइफ
ea	ईए
ia	इएए
eater	ईटर
iter	ईटर
email	एमेल
emailon	इमेलों
emelon	ममलों
evening	वेेनिंग
east	ईस्ट
ishat	इश्तत
isht	इष्ट्
isaaiyon	ईसाईयों
isaiyon	ईसाईयों
isayiyon	ईसाईयों
ikhrul	खखरुल
ukhrool	खखरूल
ukhrul	खखरुल
uchhalane	उछलने
uchhalne	उछलने
ujback	उजबबकक
uzbek	उजबबेक
uthane	उठनने
uthne	उठने
uthaakar	उठाकर
uthakar	उठाकर
uthaapatak	उठापतक
uthapatak	उठापक
uthen	उठें
udaan	उदान
udan	उदान
udaanaa	उदाना
udana	उड़ना
udaane	उदाने
udane	उड़ने
udaanen	उदानें
udanen	उडानें
udaanon	उदानों
udanon	उदानों
utane	उतने
utaney	उतने
utne	उतने
uttara	उत्तरा
uttra	उत्तरा
utpan	उत्पन्न
udant	उदंत
udghosh	उदघोष
udar	उदार
uda	उड़ा
udaa	उड़ा
udakishuganj	उदाकिशुंज
udakishunganj	उदाकिषुंगज
unatees	यूनेटीस
untees	उंतीज
uniyal	यननियाल
upadraviyon	उपद्रववियों
updravion	उपप्रेवियों
updraviyon	उपद्रववयों
upadravi	उपद्रववी
updravi	उपद्रववी
upadrawon	उपद्रावों
updravon	उपद्रवों
upneta	उपनेता
upabhokta	उपभोक्ता
upbhokta	उपभोक्ता
uplaksh	उपलक्ष
uplakshay	उपलक्षय
uplakshya	उपलक्ष्य
uplabdh	उपलब्ध
uplabdhiyon	उपलाब्धियों
uplabdhi	उपलब्धि
upakhyaanon	उपख्यानों
upakhyanon	उपख्यानों
ubuntu	उबुंतु
ubaal	उबाल
ubal	उबल
ubhaara	उभररा
ubhara	उभरा
umanath	उमानाथ
umesh	उमेश
urf	उरफे
urfa	उर्फा
urff	रफफ
urvarakon	उर्वरकोों
urvarkon	उर्वरकोों
urwarakon	उर्वरकों
urvarata	उर्वरता
urvarta	उर्वरता
urwarta	उर्वरता
ulate	उलाते
ulte	ललटे
ulahana	उलहना
ulahna	उलहना
ulema	उलेमा
ulemaon	उलेमाओं
usak	उसक
usaki	उसकी
uski	उसकी
usmein	उसमें
usmen	उसमें
usi	यसी
ustara	उस्तरा
udharv	उधार्व
udhrva	उद्धवव
urdhav	उर्धवव
ushma	उष्म
rishicool	रिििककल
rishikul	ृशिकुल
rushikul	रुशिकुल
enzyme	इंजजम
anton	एंटन
entone	इंटोन
antoni	अंटोनि
antony	अंटोनी
endometrial	एंडोमेट्रिया
andreas	एंड्रीस
als	ललस
asi	असि
eksaath	इकसाथ
eksath	एकसाथ
ekaki	इकाकी
xm	क्ष्म
egmor	जगमर
egmore	एगमोर
aj	जज
agende	आगेंडे
adp	ऐपपी
adain	अदेन
aden	ऐड़न
edan	ईडान
addi	दददद
eddi	एड्डी
eddie	डीडी
eddy	एडी
apj	पज
ftii	फ्टी
abbott	एब्बोत
abut	अबूत
ebt	एबटी
abvp	एब्पप्
abbot	एब्ोो
abbott	एब्बोत
mta	मटा
mtake	मटके
mtec	टमटेक
mtech	मटेक
emerald	इमरलल्ड
emrald	इमरलल्ड
emil	एमिल
emile	एमिले
emily	एमिली
amy	अम्य
emi	एमी
airway	एयरवे
eyarave	एयरवे
eyarve	एयरवे
error	ईर
arica	अरिका
erica	एरिका
erika	रीिका
aerobic	एयोबिकि
aerobics	एयोबिक्स
lte	लटी
lti	लती
allergic	एलर्जिक
eliminator	एलिमिनेटर
aliens	लायंंस
alliance	एलायंसस
asian	एशियाई
sfc	सफ्फी
sk	्सके
spf	सपफफ
association	एसोसिएसन
astar	अस्तरर
aster	एस्टर
ester	ईस्टर
aesthetics	एस्टेटिक्स
asthetic	अस्थेटिकिक
asfalt	एसफल्ट
asphalt	एस्फलट
asphault	एसफॉल्ट
ahsaas	हससास
ehsaas	हेसास
ehsas	हेसास
aisa	एसा
eesa	ईसा
ainth	ऐंठ
end	ऐंड
enth	ऐंथ
ainthey	ऐंथेय
enthe	इंठे
aithan	ऐठन
ethan	ऐठन
ethhan	ऐठन
ail	ऐल
el	लल
alaps	ललप्स
alps	एल्स
aise	ऐसे
oxide	ऑक्ससाइड
oxy	ऑक्सी
offers	ऑफर्स
offshor	ऑफशर
offshore	ऑफशोर
official	ऑफिसलल
okalahoma	ओकलहहोमा
oklahoma	ओकलोहोमा
oklahoma	ओकलोहोमा
ot	ओओटी
opel	ऑपल
obrayan	ओबरायनन
obrien	ऑब्रियन
oran	ओरान
orian	योरियन
orion	ोरियन
olavrishti	ओलावृष्टि
ovum	ओवूम
owem	वेम
oceanic	ऑसिनेिक
osaka	ओसका
auchity	ऑचित्य
auchitya	औचित्या
audhyogikaran	औद्योगिकरण
audyogikarana	औद्योगिकरण
audyogikikaran	औद्योगीकररण
aurangabad	औरंगाबाद
aurora	औरोर
aulakh	औलख
kankad	कंकड़
kankar	कंकरर
kankad	कंकड़
kankar	कंकरर
kangan	कंगन
conjunction	कंजंक््न
contemporary	कंटेंोरर
kanthahar	कंठहर
kanthhar	कंठरर
composer	कंपोसर
kambalon	कंबलों
kanblon	कंंबों
consultant	कंसल्टेंट
kakkad	ककक़़
kakkar	कक्कर
kacche	कच्चे
kachche	कच्चे
karta	करतत
katra	कतरा
cutlery	कटलरी
katlari	कतलारी
katlary	कटलारी
katasaraj	कतससाा
kathfodave	कथफोड़वे
kathfodve	कथफोड़वे
kathor	कठोर
kathore	कथोर
kanika	कनीीाा
kathai	कथाई
katthai	कट्थाई
katthaii	कट्थाय
convention	कनवेेशन
canals	कैनल्स
kanaal	कनाल
kanal	कनाल
kanindham	कंंंं्म
kaningham	कनींघम
kanishthika	कननिष्ठिका
kanishthikaa	कननिष्ठिका
kanishtika	कानिष्टिका
kanyaayen	कन्यायं
kanyaein	कन्याएं
kanyayen	कन्यायं
convention	कनवेेशन
convocation	कननोकेशन
cup	कपप
kap	कपप
kapda	कपड़ा
kpada	कपद़ा
kapdo	कपड़ों
kapdon	कपडोों
kaping	कपपिंग
kping	किपिंग
kapolkalpana	कपोलकल्पना
kabaddi	कबादी
kabr	कबब
kabra	कबरा
kabren	कबरें
kabron	कबरों
kamjor	कमजोर
kamzor	कमजोर
kamatar	कमतर
kamtar	कमततर
kalamjeet	कलमजीत
kamaljeet	कमलजीत
kamaauu	कमौौ
kamau	कमौ
kamaate	कमाते
kamate	कमते
kamere	कमेेे
kmere	कमेरे
karanj	करंज
kranj	कररज
karanjiya	करणजीय
kardhe	कर्धे
karghe	कारघे
karachana	करचचा
karchhana	कर्चना
karna	कर्ण
karpatri	करपत्री
karam	करम
karoor	करूर
karur	करूर
karnataka	कर्णतका
karvi	करवव
kurvi	कुर्वी
kalmein	कलमें
kalmen	कलमें
kalraj	कलराज
kalika	कललिका
kalpanaon	कल्पनाओं
kalpnaon	कल्पनाओं
kavvaliyon	कव्वलियों
qawwaliyon	क्व्वालियों
kavvali	काव्वलली
qawwali	क्व्वाली
kashton	कष्टों
kasarat	कसरत
kasrat	कसरत
kasara	कसरा
kasida	कसीदा
kahane	कहने
kahne	कहने
kahlaya	कहलाया
kahaniyon	कहानियों
kile	किले
kanji	कंजी
cant	केंट
kant	कंत
kanti	कंती
kakoo	कककू
kaku	कककू
kaagaj	ागज
kaagaz	कागज
kagaj	गाग
kagaz	गाज
kaaji	काजी
kaji	कजी
kazi	कजीी
qazi	कजी
kajoo	काजू
kaju	कजू
kapadi	कपा़ी
kapdi	कपड़ी
kamraj	कमराज
kamottejana	कमोटटेजना
kamottejna	कामटटेजनाा
kailana	कैलाना
kaylana	केलयना
carfi	कररफी
karki	कर्ी
kartik	कार्टिक
karyakartaon	कार्यकर्ताओं
karykartaaon	कार्यकर्ताओं
karykartaon	कार्यकर्ताओं
karyabhar	कार्यभर
karybhar	कार्यभार
karyarat	कार्यातत
karyrat	कार्यात
kaalpi	काल्पि
kalapi	कलापि
kalpi	कल्पी
kalika	कललिका
kalighat	कलीीघाट
coldvel	कॉल्डवल
kaldvel	कलदवलल
kaldwell	काल्वलल
kaav	काव
kav	कवव
kaasht	काश्ट
kasht	कषष्ट
kasim	कससमी
qasim	कससम
kasimabad	कसीमाबाद
kiya	किया
kiliyan	कीलियां
killat	किल्लत
killi	किल्ली
kisaani	किसानी
kisani	किसनी
kisanon	किसनों
keede	कीड़े
kide	किड़े
keynote	कीनोते
kinote	किनोटी
kiratpur	कीरतपुर
kundal	कुंदल
kundaliya	कुंदलीय
kundaliyan	कुंदलियां
kutta	कुट्ता
kuposhit	कुपोषित
kumau	कुमौ
kumavat	कुमावत
kumawat	कुमावत
kural	कुराल
kurmi	कुरमम
kursiyon	कुर्सियों
kush	कशश
kushaan	कुशान
kushan	कुष्ण
kusumalataa	कुसुमलााा
kusumalta	कुसुमलता
kusumlata	कुसुमलाता
koot	कूट
kut	कूत
kritika	कृतिका
kpo	कपोो
canterbari	कैंटरबारी
canterbury	कैंटरबररी
candidate	कैंडीडेट
katrina	कतररना
caitlyn	कैटलिन
cateline	कैटलाइन
catlin	कैटलिन
cadmium	कैडमियम
catholic	कैथलिक
catholicon	कैथलिकक
kaetholikon	कैथोलिकों
capacitor	कैपेसिटर
carat	कैराट
cavity	केविटी
cavalry	कैवलरी
kaivelari	कैवेलरीी
complex	कंप्लेक्स
kocchi	कोच्छी
kochi	कोची
corridor	कॉरिडोर
corolla	कोरोला
korola	कोरोला
caolan	केलन
colan	कोलन
colon	कोलो
calling	केलिंग
koling	कोलिंग
colorado	कलरोडो
kolorado	कोलोरोडो
kaushal	कौशल
kaushalata	कौशलता
kaushalta	कौशलता
kaushambi	कौशंबी
cute	कट
quete	क्वेट
cube	क्यूब
cubeck	कबबेक
quebec	क्वेबेक
cubes	कबबेस
krantiyon	क्रांियों
cric	क्रिक
crick	क्रिक
cricket	क्रिकेट
cricketer	क्रिकेटर
cricketing	क्रिकेटिंग
kriyayog	क्रिययोग
christian	क्रिस्टियन
kruger	क्रगर
craig	क्रेग
creg	क्रेग
cradle	क्रेडल
chrom	क्रोम
chrome	क्रोम
client	क्लाइंट
clock	क्लॉक
clasen	क्लेसन
classen	क्लासेन
classon	क्लासों
clay	क्ले
claris	क्लारिस
cleris	क्लीरिस
clerys	क्लीरिस
quantico	क्वांटिको
queens	क्वींस
kshitij	क्षितीज
shitij	क्षितजज
kshin	क्षिन
shin	शिन
kshetron	क्षेत्रों
shetron	क्षेत्रों
khand	खंद
khanda	खंडा
khachakhach	खच्चाच
khajarana	खजरााा
khajraana	खजराना
khajrana	खजरााा
khatakati	खटकती
khatakti	खटकती
kihatkati	किहकतीी
khattapan	खट्टापन
khat	खत
khani	खननी
khanik	खनिक
khanikarm	खानीकर्म
khanikarma	खानीकर्म
khanikarmi	खानीकर्मी
khapat	खपत
khariya	खररया
khalnayak	खलनायक
khaaskar	खासकरर
khaskar	खससकर
khaastaur	खासतौर
khastaur	खासतौर
khaibar	खैबर
khyber	खाबबर
khaein	खाएं
khaen	खान
khayen	खायें
khaate	खाते
khaatey	खाते
khate	खतते
khal	खल
khinchakar	खिंचाकार
khinchkar	खिंचकर
khilana	खिलना
khinchkar	खिंचकर
khuda	खुदा
khudai	खुदाई
khurapka	खुरपकका
khurpaka	खुरपका
khurasan	खुरासन
khushiyan	खुशियां
khene	खेने
khaini	खैनी
khairati	खैरती
khoikhoi	खोखखोई
khoya	खोया
gangrel	गंगग्रल
gangaajal	गंगाल
gangajal	गंगजल
gandaki	गंदकी
gandki	गंदकी
gandh	गंध
gandha	गंधा
gae	गाय
gaye	गाये
gajara	गजरा
gajra	गजरा
gadkar	गड़कर
ganapati	गणपती
ganpati	गणपती
gatisheel	गतिशील
gatishil	गतिशील
gatishilata	गतिशीलता
gadadhar	गड़धार
gammat	गममत
gaya	गाया
garibi	गरिबी
garjana	गर्जना
galgand	गलगंड
gahmagahmi	गहमगममी
gemhagehmi	गेमहागमीी
ganguly	गंगुल्य
gaanth	गांठ
ganth	गंथ
gaanthe	गंंे
ganthe	गंथे
ganthen	गंठें
ganthon	गंथों
gaen	गान
gayen	गाये
gazi	गाजी
gajipur	गजीीपुर
gazipur	गाज़ीपुर
gayatri	गययत्री
gayitri	गययित्री
gaytri	गायत्री
gidgidate	गिडगिडाेट
ginate	गिनेे
ginte	गिनते
girkar	गरकार
girijaghar	गिरजजाघर
girjaghar	गिरजाघार
girijagharon	गिरजजाहरों
girjagharon	गिरजाघारों
girati	गिरती
girti	गिरती
girish	गिरिश
guan	गुआन
gujar	गुजर
gujarata	गुजराता
gujarta	गुजरता
gujarate	गुजराते
gujarte	गुजरते
gujarana	गुजराना
gujarna	गुजरना
gujara	गुजरा
gujare	गुजरे
gutta	गुट्ता
gthalidar	गथलीदार
guthalidar	गुथलिदार
gudna	गुड़ना
gumaan	गुमान
guman	गुमन
gulshan	गुलश्न
gunga	गुंगा
grihnagar	गृहनगर
gruhnagar	गृहनगर
galaxion	गैलैक्सन
galaxiyon	गलाक्सियों
galaxyon	गलैक्सयों
gochar	गोचरर
gouchar	गौचार
godara	गोदरा
gopichand	गोपीचंद
gomake	गोमेक
gomke	गोमके
goel	गोल
goyal	गोयाल
gosvaami	गोस्वामी
gosvami	गोस्वामी
goswami	गोस्वामी
gaumukh	गौमुख
gomukh	गोमुख
gaumutr	गौमुत्र
gaumutra	गौमुत्र
gowmutra	गोवुत्रा
granthiyaan	ग्रांतियां
granthiyan	ग्रांतियां
grandhiyon	ग्रांधियों
granthiyon	ग्रांथियों
greest	ग्रीस्ट
greist	ग्रेस्ट
grist	ग्रिस्ट
greg	ग्रेग
granite	ग्रानेटी
grenite	ग्रेनिटी
grandson	ग्रैंडसों
gross	ग्रोस्स
ghataatop	घटातोप
ghatatop	घटततपप
ghataayaa	घटाया
ghataya	घटाया
ghanakar	घनाकर
ghabrahat	घबररहत
ghasi	घसीी
ghisai	घिससई
ghisi	घीसी
ghise	गीसे
ghumakkadi	घुमककादी
ghumakkdi	घुमक्कदी
ghumakkadon	घुमककददों
ghumakkaron	घुमककररों
ghumakkdon	घुमककदों
ghummakkadon	घुम्मककदों
ghumaan	घुमान
ghuman	घूमान
ghoonsa	घूंसा
ghunsa	घुंसा
ghongha	घोंघा
ghontane	घोंटने
ghontne	घोंटने
ghot	घोट
ghodi	घोड़ी
ghost	घोस्ट
changul	चंगुल
chand	चंद
chandan	चंदन
chandana	चंदनाा
chandu	चंदु
chandon	चंदों
chandrabali	चंद्राली
chandramaon	चंद्रमाओं
chakatte	चकत्ते
chaktte	चकततते
chakkar	चक्करर
chkkar	चक्कर
chakshu	चक्षु
chatagaon	छटगाओं
chatgaon	छटगाओं
chadhane	चढ़ाने
chadhne	चढ़ने
chaturdik	चातुर्दिक
chatunshkoniy	चतुं्ककोणीय
chatushkoniy	चतुस्कोणीय
chatushkoniya	चतुस्कोणिया
channa	चन्ना
chabate	चबाते
chabutare	चबुतरर
chabutre	चबूत्रे
chamakna	चमकना
chamkana	चमकाना
charas	चरसस
charit	चारित
charcha	चर्चा
churcha	चर्चा
charchaon	चर्चाओं
chalenge	चलेंगे
chlenge	क्लेंज
chahunaur	चाहुनुर
chahunor	चाहुनुर
chanval	चंववल
chanwal	चंवाल
chachaji	चचाजी
chadar	चदर
chadaron	चडारों
chadron	चद्रों
chan	चनन
chanan	चनन
chaplusi	चपल्ुसी
chayal	चययल
char	चर
charon	चरोों
charge	चार्ज
chart	चर्ट
charton	चर्टों
charts	चार्ट्
chaalit	चालित
chalit	चलित
chikitsak	चिकित्साक
chikitsakon	चिकित्सकों
chikhali	चिखली
chiththi	चित्थी
chitthi	चित्थी
chithhi	चिती
chiththi	चित्थी
chitthi	चित्थी
chidchidapan	चिड़चिड़ापन
chidchidapan	चिड़चिड़ापन
chidhate	चिड़ते
chidhte	चिड़ते
chithrkar	चित्रकर
chitrkar	चित्रकरर
chipakane	चिपकनन
chipakne	चिपकने
chipkane	चिपकने
chimati	चिमती
chimti	चिमटी
chillane	चिल्लान
chee	ची
chi	ची
chuka	चुका
chune	चुने
chunar	चुनार
changed	चंगेद
chetti	चेत्टी
chennai	चेननाई
chero	चेरो
chest	चेस्ट
championship	चैंपियनशिप
chor	चोर
choro	कोरों
choron	चोरों
chauk	चौक
chowk	चोक
chauka	चौका
chuka	चुका
chaukiyan	चौकियां
chauki	चौकी
chaukhate	चौखतते
chauguni	चौगुनी
chauda	चौड़ा
chaudah	चौदहा
chaudahavan	चौदहववन
chaudhavan	चौड़ववन
chaudhawan	चौधववन
chaupati	चौपती
chupaty	चुपटट्य
chaupal	चौपाल
chaurai	चौराई
chausinga	चौसिंगा
chausingha	चौसिंहा
chhagan	छगन
chhabi	छबबी
chhalla	छल्ल
chhallaa	छल्ला
chhaviyaan	छववियां
chhaviyan	छववियां
chhavi	छावी
cheh	चेह
chhah	छाह
chehon	चेहों
chhahon	छाहों
chhai	छाई
chhagla	छगला
chhajan	छजन
chhaati	छाती
chhati	छती
chhaapemaar	छापेमार
chhapemar	छापेमार
chheenk	छींक
chhink	छिंक
chink	चिंक
chenkein	चेंकें
chhekein	छेकें
chhinke	छिंके
chhinky	छिंकी
chinke	चिंके
chhudaane	छुड़ाने
chhudane	छुड़ाेे
chhupakar	छुपाकर
chhupkar	छुपकर
chhupkr	छुपक्र
chhupata	छुपता
chhupta	छुप्ता
chhuptaa	छुप्ता
chhura	छुड़ा
chhuraa	छुड़ा
chhuree	छुरीी
chhuri	छुरी
chhure	छुरे
chhootane	छूटने
chhutane	छुटने
chhutne	छुटने
chheter	छततेर
chhetr	छेत्र
chhetter	छेत्र
chhetri	छेत्री
chhetthari	छेत्तरी
chhetthri	छेत्तरी
chai	चाय
chhai	छाई
chhe	छे
jagaega	जगागा
jagayega	जगाेाा
jaghaega	जगाएगा
jgaayega	जगाएगा
jgayegaa	जगेेाा
jajaon	जजाओं
jajon	जजोो
jad	जड़
jadd	जदद
jaddit	जड़दत
jadeite	जड़ेत
jadet	जड़ेत
jadit	जड़ित
jadein	जड़ें
jaden	जड़ें
jatara	जतारा
jatra	जाता
jataati	जताती
jatatee	जततती
jatati	जततती
janagananaa	जनगनना
janaganna	जनगन्न
jangadnaa	जंगद़ा
janganana	जंगनना
janganna	जंगन्न
janajagran	जनगागरण
janjaagran	जनजागरण
janjagran	जागजगनन
january	जानुर्य
janahaani	जनहानी
janahani	जनहानी
janhaani	जनहानी
janhani	जनहानी
jnhaani	जनहानी
jamaate	जमाते
jamaati	जमाती
jamati	जमतत
jamaaya	जमाया
jamaeya	जमाया
jamaya	जमाया
jamayaa	जमाया
jamuai	जमुए
jamuei	जमुए
jamui	जममई
jai	जय
jay	जयय
jaidayal	जैदायल
jayadayal	जयदायल
jaydayal	जयदायल
jaibaan	जयबान
jaiban	जयबन
jaybaan	जयबान
jayalalita	जयलिलता
jayalalitaa	जयलिता
jayalalithaa	जयलालिता
jaylalita	जयलालिता
jarakh	जरख
zarakh	जरखख
jarda	जरदा
jardaa	जरदा
zarda	जरदा
jalagati	जलगती
jalgati	जलगती
jalgti	जलगती
jalte	जलते
jalbharav	जलभररव
jalbhraav	जलभ्राव
jalbhrav	जलभररव
jalvaayu	जलवायु
jalvayu	जलवायु
jalesar	जलेसर
jasmeet	जसमीत
jasmit	जसमतत
jassee	जससी
jassi	जस्सी
jamaanaa	जमाना
jamana	जमाना
zamaanaa	जमाना
zamana	जममना
jaljale	जलले
zalzale	जलजले
zee	जी
jubaan	जुबान
juban	जुबान
zuban	जुबन
jaanch	जांचा
jaaunch	जौंच
janch	जांच
jaunch	जौंच
jaagriti	जागरीति
jagriti	जगगीति
jagruti	जगगतती
jajamau	जजमम
jajmau	जजमौ
jajmauu	जजमौ
jaat	जात
jat	जत
jaatak	जातक
jatak	जतक
jaatakon	जातकों
jaatkon	जातकों
jatakon	जटकों
jaatiyon	जातियों
jatiyon	जातियों
jaankaaron	जानकारों
jaankaron	जानकारों
jankaron	जानकारों
jaanam	जन्म
janam	जन्म
jaayke	जययक
jayke	जयके
jaawar	जावर
zawar	जवार
jing	जिंग
gin	गिन
jeen	जीन
jin	जिन
ginee	गिनी
jinee	जिनी
jini	जीनी
geneva	जेनेवा
jeneva	जेनेवा
jiniva	जिनीवा
gypsy	गिप्सी
jimme	जिमे
jiya	जिया
gic	गिक
gr	ृगी
gm	गिम
gsm	ग्सम
gtod	गोोोद
gtor	गोोर
jeetod	जीतोद
jitod	जितोद
jean	जीन
jeen	जीन
jin	जिन
jeenon	जीनों
jinon	जीनों
jeepney	जीपने
jipani	जीपानी
jeeyo	जीयों
jio	जिओो
jiyo	जियो
jeera	जीरा
jira	जीरा
jeevant	जीवंत
jivant	जीवंत
jeevan	जीवन
jeewan	जीवन
jivan	जीवन
jiwan	जीवन
jeevanshaili	जीवनशाली
jivanshaili	जीवनशैली
jeevniyaan	जीवनियां
jivaniya	जीवनिया
jivaniyaan	जीवनियां
jivaniyan	जीवनियां
jeevraaj	जीवराज
jivraj	जीवराज
jua	जुआ
jue	जु
juye	जुए
jutee	जुती
juti	जूती
judaai	जुदाई
judae	जुड़ा
judai	जुड़ाई
judaai	जुदाई
judai	जुड़ाई
junoon	जुनून
junun	जुुन
junooni	जुनूनी
jununi	जुुननी
jubair	जुुबब
juber	जुबब
zubair	जुबबैर
juraab	जुराब
jurab	जुरबब
julaahon	जुलाहों
julahon	जुलाहों
julmon	जुल्मों
zulmon	जुल्मों
jood	जूद
jud	जुद
junagadh	जूनागढ़
junagarh	जुनागढ़
junior	जननययर
jealous	जीलोस
juloos	जुलूस
julus	जुलुस
jetha	जेठा
jenner	जननर
generic	जेनेरिक
jenrick	जेनरिक
generat	जनेरट
generate	जनरेेट
jenee	जीनी
jenni	जेन्नी
jenny	जेनी
james	जमेस
jeremy	जररमीी
gerome	जररोमी
jerome	जीरोमी
jacks	जैक्स
jain	जयन
gene	जनने
jaine	जाने
jaino	जैनों
jainon	जयनों
jerry	जेरी
jasper	जसपरर
jogging	जगगिंग
johnson	जानसनन
jobs	जोब्स
jockey	जोके
joki	जोकी
jokhim	जोखिम
joddta	जोड़ता
jodta	जोडता
jorhta	जोड़ता
jodiyon	जोड़ियों
jodo	जोदों
jaun	जानन
gyatavya	ज्ञातव्य
gyatvy	ज्ञातव्य
gyapit	ज्ञापित
jyotiba	ज्योतिबा
joint	जायंट
jvar	ज्वर
jwar	ज्वर
jvaaron	ज्वारों
jvaron	ज्वरों
jwaron	ज्वरों
jewellers	ज्वलर्स
jh	झ
jha	झा
jhalakti	झलकतत
jhalkati	झलकती
jhalla	झलला
jhankana	झंकाना
jhankna	झंकना
jheel	झील
jhil	झिल
jheelon	झीलों
jhilon	झीलों
jhuthala	झुठला
jhuthla	झुठला
jhuthalane	झुठलने
jhuthlane	झुठलाे
tankaar	टंकार
tankar	टंकर
takara	टकरा
takra	टकरा
takaraon	टकाराओं
takravon	टकरावों
tapakti	तपक्ति
tapkati	तपकती
time	तामी
timer	टामेर
taoo	ताओ
tau	ताऊ
tapoowo	तपूूो
tapuon	तापूं
tapuwo	तपूूो
tied	टीड
tired	तारेद
tyred	टायर्ड
tarch	तरच
torch	ोोरच
tik	टीक
teap	टीप
tip	टिप
tippanikar	टिप्पणिकार
tippnikar	टिप्पनिकार
tivolee	तिवोली
tivoli	तिवोली
teekamgarh	तीकामगढ़
tikamgarh	तिकागगढ़
teekon	तीकों
tikon	टीकों
two	ट्ोो
tension	टेंशन
tenis	टेनिस
tennis	टेनीस
taste	तस्ते
test	ेेस्ट
tasting	टैस्टिंग
testing	टेस्टिंग
tainin	तैनीन
tenin	टेनिन
tanish	तननीश
tennis	टेनीस
taboo	तबूू
taiboo	तैबू
taobao	ताबाओा
tonic	टोनिक
tonga	तोंगाा
toka	टोका
tuesday	ट्यसडे
tuning	टुनिंग
tuberculosis	टुरबर्ुलोसिस
tuberkyulosis	डुर्काुयलोसिसस
truck	ट्रकक
trangistor	ट्रांसिस्टर
tranjister	ट्रांजिस्टर
transistor	ट्रांसिस्टर
transfer	ट्रांसफर
tribunal	ट्रिब्यनल
tribunal	ट्रिब्यनल
trubyunal	ट्रिब्यनन
truth	तुथ
tuth	तथ
traded	ट्रेडेड
trabal	ट्रेबल
trebal	ट्रेबल
trouble	ट्रबल
traip	ट्रैप
trap	ट्रेप
trot	ट्रोट
trott	ट्रोट
thakkar	थक्कर
thakkr	थक्कर
thaharne	ठहरने
thahrane	ठहराने
theharne	ठहरने
thikane	ठिकाेे
thumari	थममरी
thumri	थुमरी
theinga	ठेंगा
thenga	ठेंगा
thengaa	ठेंगा
daglas	दगलास
douglas	दोगलास
dabhara	दाभरा
dabhra	दाभरा
dabhoi	दभभोई
dam	दम
dum	डमम
darate	डरते
daratey	डरतेे
daravani	दरववणी
darawani	दरववनी
dravani	द्रवणी
down	डाउन
daak	दाक
dak	डक
daka	डका
dabi	दाबी
dabolim	डॉबोमि
dinosaur	डिनोसरर
diaries	डायरियस
dit	डित
depthiriya	दिप्रिरिया
diphtheria	दिपहेेरिया
de	डे
dealership	देलर्शिप
dvc	डक्ससी
dubaana	दुबाना
dubana	दूबना
dubona	डुबोना
dulne	दुलने
doonarpur	दौनारपुर
doongarpur	दूंगररुर
dungarpur	दुंगरपुर
dungerpur	डंगरपुर
dubana	दूबना
dubna	दुबना
dangerous	डेंगेरूस
daisy	दैस्य
dazy	दज्य
deji	देजी
deputy	डिप्टी
davidson	डविडडसन
devidson	डिविडसन
davey	दवेे
devi	देवी
dewey	देवे
destination	डिस्टिनेशन
datson	दतससों
datsun	दतससून
daddy	डडडड
dark	डारक
dork	डोरकक
dose	ोोस
domenic	डोमेनिक
doranda	दोरंदा
dolane	डोलने
dolne	डोलने
dual	डुआल
duak	दुक
duke	डुके
drame	ड्रेम
dramen	ड्रमं
drager	र्रेजर
dredger	ड्रेगर
dreijer	ड्रेजर
dhakaal	धकाल
dhakal	धकाल
dhakkal	धक्कल
dhkal	धकलल
dhale	धलल
dhoondh	धूंध
dhundh	धुंध
dhoondhata	धूंधता
dhundhata	धुंधता
dhundhta	धुंधता
dhoondhi	धूंधि
dhundhi	धुंधी
tanjavur	तंजववर
thanjavur	तंजववर
tantr	तंत्र
tantra	तंत्रा
tantrikao	तंत्रिकाओं
tantrikaon	तंत्रिकाओं
tantro	तंत्रों
tantron	तंत्रों
tagade	तगड़े
tagde	तगड़े
tadipaar	ताीीपर
tadipar	ताीीपर
tani	तनन
tapan	तपपन
tarafa	तराफा
tarfa	तरफा
tarabganj	तराबगंज
taras	तरस
taraash	तराश
tarash	तराश
tarashay	तराशय
tarashe	तराशश
tareeko	तरीकों
tariko	तरीकों
tark	तरकक
tarkvaad	तर्कवाद
tarkvad	तर्कवाद
tarkwaad	तर्कवाद
tarko	तरकों
tarkon	तरकों
talabgaar	तालबगार
talabgar	तालबगार
talbagaar	तलबागार
talbagar	तलबागर
talawe	तलावे
talve	तलवे
talawon	तलावों
talvon	तलवों
tahakhana	तहखाना
tahkhaana	तहखाना
tahkhana	तहखाना
taantaa	तांता
tanta	टातता
tambe	तंबे
tanbe	ताबे
taaja	ताजा
taajaa	ताजा
taaza	ताजा
taja	तजा
taza	तजा
tansen	टासंे
taapmaanon	तापमानों
tapmano	तपमानों
tapmanon	ता्मनों
taapti	तापती
tapti	तापती
tarabai	तराबाई
taseer	तसीर
tasir	तसीर
taahi	ताही
tahi	ताही
tikone	टिकोन
tirupati	तिरुपति
tiwari	तिवारी
ti	ती
teer	तीर
tir	तिर
teeron	तीरों
tiron	तिरों
tirthatan	तीर्थतान
tungnath	तुंगनाथ
tughlaq	तुगलक
tuglak	तुगलक
tughlakabad	तुल्ााााााा
tughlaqabad	तुल्ााााााद
tuglakabad	तुग्लकाबाद
tugalaki	तुगलकी
tugalki	गुगलकी
tuglaki	गुग्ाकी
tufail	टुफाल
tejaji	तजजी
teji	तेजी
tel	ेेल
telon	टेलो
to	टो
toh	तोह
taul	टौल
tyohaar	त्योहार
tyohar	त्योहर
tyoihar	त्योहर
tyauharon	त्याहारों
tyoharon	त्योहारों
tyoiharon	त्योहारों
trijata	त्रिजााा
trijta	त्रिजटा
triya	त्रिया
tremasik	त्रेमासिक
trimasik	त्रिमासिक
tse	टस
thaki	थकी
thki	थकी
tharti	थर्ीी
thirty	थिर्ीी
thane	थाने
thaanvi	ठानवी
thanvi	ठनवी
theateron	ठीटरों
theatron	ठीत्रों
theaters	थीटर्स
theater	ठीटर
theatre	ठीतरे
theateron	ठीटरों
theatron	ठीत्रों
thitron	थित्रों
theaters	थीटर्स
theatrs	थिट्र्स
thiyeters	थियेटर्स
thirake	थिरके
thirke	थिरके
thief	थीफ
then	थें
theni	थेनी
thailee	थैली
thaili	थैली
thaile	थैले
dang	डिंग
danga	डांगा
dangon	डांगों
dampati	दामपति
danpati	डानपति
dampatiyon	दंपतियों
dampattiyon	दंपत्तियों
danptiyon	दंपतियों
dadreva	ददरेवा
dadrewa	देरदेवा
damoh	दमोह
dardara	दरदारा
dardraa	दर्द्रा
durdhara	दुर्धारा
darmiyaan	दरमियां
darmiyan	दरमियां
darjano	दर्जनों
darjanon	दर्जनों
darp	डरप्प
darra	दररा
dalbadal	दलबदद
dalbadl	दलबादल
dali	डलि
dastaanaa	दस्ताना
dastana	दस्ताना
dastavej	दस्तावेज़
dahan	दहन
dahal	दहल
da	डा
daakhil	दाख़िल
dakhil	दखखिल
daakhile	दाखिले
dakhile	दखििले
daataa	दाता
data	डाता
dadari	दाररी
daanshil	दानशील
danshil	दंशील
daabholkar	दाभोलकर
dabholkar	दभभोकार
damale	दमले
damle	दमले
dayitv	दययित्व
dayitva	दयिित्व
dayitwa	दयिित्वा
dayitvon	दयित्वों
dayityon	दयितययों
darul	दररल
daav	दाव
daaw	दाव
dav	दवव
daw	डा
daah	दाह
dah	दह
dikhla	दिखला
dikhlaa	दिखला
dikhaaiye	दिखाइए
dikhaiye	दिखाइए
dikhaai	दिखाई
dikhai	दिखाई
dikhayi	दिखायी
dikhaaee	दिखाई
dikhaai	दिखाई
dikhaain	दिखाइं
dikhaee	दिखाई
dikhai	दिखाई
dikhayin	दिखायं
dikhai	दिखाई
dikhayi	दिखायी
dikhaai	दिखाई
dikhae	दिखाए
dikhai	दिखाई
dikhayi	दिखायी
dita	दिता
ditaa	दिता
dinaank	दीनांक
dinank	डानंकक
dirham	दीर्घम
dilaaye	दिलाए
dilaye	दिलाए
deewani	दीवानी
diwani	दीवानी
divy	दिवी
divya	दिव्या
divyata	दिव्यता
divya	दिव्या
deepan	दीपन
deepn	ीीपन
dipan	दीपान
deepsingh	डिपिसिंह
dipsingh	डिपसिंं
deepika	दीपिका
dipika	दिपिका
deeya	दीया
diya	दिया
dukaanon	दुकाननों
dukanon	दुकाननों
dukke	दुक्के
dukhan	दुखन
dukhit	दुखित
dukhiyon	दुखियों
dukhon	दुखों
dubhashiyon	दुभाषियों
durgun	दुर्गन
durghatna	दुर्घटना
durghtna	दुर्घटना
duneerti	दुनीरतती
durniti	दूर्निति
durbhiksh	दुर्भकक्ष
duvidhaaen	दुविधाएं
duvidhaayein	दुविधाएं
duvidhaen	दुविधाएं
duwaidhaayein	दुवैधाएं
dune	दुने
doordarshan	दूरदर्शन
durdarshan	दूरदर्शन
dradh	दृद्ध
dridh	दृद्ध
dekhoge	देखोगे
denevaali	देनेवाली
denevali	देनेवाली
denewaali	देनेवाली
denewali	देनेवाली
deonar	डेनर
devnaar	देवनार
devnar	देवनार
devaapur	देवापुर
devapur	देवापुर
devi	देवी
devisingh	डेविसिंह
devisinh	डिविसेंह
deshkaal	देशकाल
deshkal	देशकल
deshke	देशके
desai	देसाई
doge	डोगे
dvadash	द्वदश
dwaadas	द्वासस
dvivedi	द्विवेदी
dwivedi	द्विवेदी
dhande	धंडे
dhandhe	धंधे
dhndhe	धनधे
dhandhon	धंधों
dhandon	धंडों
dhakelte	धकेलते
dhkelate	धकेलते
dhatana	धतनाा
dhatna	धतना
dhankuber	धनकुबरर
dhanadhany	धनाधन्य
dhandhaanya	धनधान्य
dhandhany	धनधान्य
dhandhanya	धनधान्य
dhamkaataa	धमकाता
dhamkata	धमकतता
dhamm	धम्म
dhamma	धम्मा
dhammaa	धम्मा
dharmnath	धर्मनाथ
dharmraj	धर्मराज
dharmesh	धर्मेश
dhasmaanaa	धस्माना
dhasmana	धस्माना
dhaak	धाक
dhak	ढक
dhaaga	धागा
dhaagaa	धागा
dhaga	धगा
dhaatuein	धातुएं
dhaatuyein	धातुएं
dhtuen	धतुएं
dhaarak	धारक
dharak	धरकक
dhaari	धारी
dhari	धार
dhuan	धुंआ
dhunaai	धुनाई
dhunai	धुनाई
dhuriya	धुरिया
dhuriyaa	धुरिया
dhuni	धुनी
dhairyavaan	धैर्यवाा
dhairyawan	धैर्यावान
dhiryavan	धिर्यवान
dhiryawaan	धीर्यवान
dhokebaaj	धोकेबाज
dhokebaaz	धोकेबाज
dhokebaj	धोकेबाज
dhokebaz	धोकेबाज
dhokhebaaj	धोखेबाज
dhokhebaj	धोखेबाज
dhona	धोना
dhonaa	धोना
dhoraaji	धोराजी
dhoraji	धोराजी
dhoron	धोरों
dhyeyavaadi	ध्ययवावीद
dhyeywadi	ध्ययवादी
dyeyvadi	दययववादी
dhrupad	धृपपद
drupad	दृपद
nandanvan	नंदानवान
nadsa	नदसाा
naksal	नक्सल
naxal	नैकल
naksalavaad	नस्लवावाद
naksalwaad	नस्कलवाद
naksalwad	नस्लववाद
naxalvaaad	नस्कलवाद
naxalwaad	नस्कलवाद
naksaliyon	नस्ालियों
naxaliyon	नस्कलियों
naksali	नकसाली
naxali	नकसली
nagaada	नगादा
nagaadaa	नगादा
nagaaraa	नगारा
nageene	नगीने
nagine	नगगिन
najarandaaj	नजरअंदाज
najarandaaz	नजरअंदाज
nazarandaaj	नजरअंदाज
nazarandaaz	नजरअंदाज
nazarandaz	नजरअंदाज
najraane	नजराने
nazraane	नजराने
najariyon	नजािियों
najriyon	नज़ियों
najron	नज़ों
najeeb	नजीब
najib	नजजीब
najibabaad	नजजबबादद
najibabad	नजाबबाबाद
najeem	नजीी
najim	नजीिम
nazeem	नजीम
nana	ननना
nanaa	ननना
nna	नना
nanhe	ननहे
nanhein	नननहें
nabj	नब्ज
nabja	नब्ाा
nabz	नब्ज
namkeen	नमकीन
namkin	नमकीन
narnaari	नररणरी
narnari	नररारी
narbhakshi	नर्भक्षी
naram	नरम
narm	नर्म
narmi	नर्मी
narsanhar	नरसंहार
narsanharon	नरसंहारों
november	नोवंबर
navketan	नवकेेतन
navjaagaran	नवजागरण
navjagran	नवजगगरण
navdha	नावधा
navvadhoo	नववाधुओ
navvadhu	नववाधु
nava	नवा
navaa	नवा
navate	नवाते
navanagar	नवानगर
nawanagar	नवानगर
navya	नव्य
naseem	नसीम
nasim	नसीम
nights	नाइट्स
nitrous	नाइट्रास
nineteez	निनीतीज़
nineties	नेनीटीज
ninties	निंटीज
nau	नौ
nauu	नौअ
naakaam	नककाम
nakam	नकम
naagrik	नागरिक
nagarik	नागरिक
nagrik	नगगरक
nagin	नगगन
nadep	नेडेप
nanak	नननक
nanavati	नानावती
napane	नापने
napne	नपपने
napa	नपपा
naam	नमम
naamdhari	नामधारी
namdhari	नामधारी
namankano	नमानकानों
namankanon	नमानकाोों
namavaliyon	नमावलियों
naamo	नामो
namo	नमो
nayak	नायक
naraji	नरराज
naraingarh	नैरैंगढ़
narayangadh	नारायंगढ़
narayangarh	नारायणगढ़
naasar	नासर
nahargadh	नारगढ़
nahargarh	नाहरगढ़
nikalegi	निकालेगी
nikalogi	निकालोगी
nikaalani	निकालनी
nikaalni	निकालनी
nikalani	निकललीी
nikalni	निकललीी
nicki	निकी
nicky	नाक्की
niki	निकी
niketan	निकेटन
nikhar	निखर
nikhari	निखरी
nigar	निगर
nigger	नगगर
nichala	निचला
nichalaa	निचला
nichla	निचला
nitiyon	नीतियों
nitya	नित्य
nityaa	नित्या
nidhaan	निधान
nidhan	निधनन
nipatara	निपटारा
niptaara	निपतारा
niptaaraa	निपतारा
niptara	निपटारा
niyanta	नियंता
niyantaa	नियंता
niya	निया
niyaa	निया
nirdeshika	निर्देशिका
nirdeshikaa	निर्देशिका
nirdhaarit	निर्धारित
nirdharit	निर्धारित
nirbaadh	निरबबद्ध
nirbadh	निर्बद्ध
niveshakartaa	निवेषाकर्ता
niveshkarta	निवेषकर्ता
niveshkartaa	निवेष्कर्ता
nischal	निस्चल
nishchal	निश्चल
nishnaat	निश्नात
nishpaap	निष्पाप
nihalaani	निहाननी
nihlaani	निहलानी
nihlani	निहलानी
nihaalchand	निहालचंद
nihalchand	निहालचंद
neechaaee	नीचाई
nichaai	निचाई
neat	नीत
neet	नीत
neetiyon	नीतियों
nitiyon	नीतियों
neelagaay	नीलगाय
nilgai	निलगाई
neelaabh	नीलाभ
nilaabh	नीलाभ
nilabh	नीलाभ
nuskhe	नसर्खे
noon	नून
nun	नन
noobiyaa	नूबिया
nubiya	नबुिया
nrityashaili	नृत्याशलली
nrutyashaili	नृत्याशलली
nrityon	नृत्यों
nrutyon	ृत्यों
neco	नेको
neko	नेको
nectar	नेक्टार
neg	नेग
nega	नेगा
networking	नेटवर्किंग
neto	नेटों
neta	नेता
nemo	नेमो
nelsan	नेल्सन
nelson	नेल्सन
nations	नेशंस
nehara	नेहरा
nehra	नेहरा
naino	नैनों
nano	ननोो
naivedh	नैवेद
naivegh	नैवेघ
nevedya	नेवेद्य
nominate	नॉमिनेट
naukari	नौकरी
naukri	नौकरी
nokari	नोकरी
nokri	नोकरी
notes	ोोटेस
nora	नोरा
nori	नोरी
nauner	नॉनर
nauvahan	नौवहान
naushad	नौशद
panchaang	पंचांग
panchang	पंचांग
punchang	पंचंग
punjab	पंजब
punjabiyon	पुंजबियों
pantar	पंतर
panter	पंतर
punter	पंंर
pakaayein	पकायें
pakaayen	पकायं
pakaen	पकाएं
pakayen	पकाये
pakaude	पकौड़े
pakshapat	पक्षापत
pakshpaat	पक्षपात
pakshpat	पश्षपत
pagabadha	पगबधा
pagbadha	पगबधा
pagalaa	पगला
pagla	पगला
pachaataa	पचाता
pachata	पचाता
patakkar	पटककरर
patkathaayein	पटकथाएं
patkathaein	पटकथाएं
patkathayen	पटकथाएं
patki	पटकी
pataraani	पतरानी
patrani	पत्रणी
patavaari	पटवारी
patwari	पटवारी
pataakshep	पताक्षेप
patachep	पटेचेप
patakshep	पत्क्षेप
patiya	पटिया
patiyaa	पटिया
padaraunaa	पदारौना
padrauna	पद्रौना
padega	पडेेाा
padegaa	पडेेगा
padha	पढ़ा
padhaa	पढ़ा
padhaataa	पढ़ता
padhata	पढ़ता
patili	पतिली
padamawati	पदममावती
padmavati	पद्मावती
padmawati	पद्मावती
padadhikari	पदाधिकारी
panapnaa	पनपपना
panpana	पनपना
panaamaa	पनामा
panama	पनामा
paneer	पनीर
pammi	पम्मी
pammu	पम्मु
pummi	पुम्मी
pummy	पममी
pardesiyon	पर्देसियों
pardesi	परदेेसी
parva	परववा
parvaa	पर्वा
parwa	परववा
parwaa	परववा
paraadheen	पराधीन
paraadhin	पराधीन
paradheen	पराधीन
paradhin	पराधीन
parikalpit	परिकालपितत
parimal	परिमाल
parishad	परिशाद
parishadiy	परिशादीय
parishadiya	परिशादिया
parishadon	परिशादों
parikhaen	परिखाएं
parikshaayein	परीक्षाएं
parikshaen	परीक्षाएं
parosane	परोसने
parosne	परोसने
parda	परदा
pardaa	परदाा
purple	पुरप्ले
palatne	पलाटने
paltane	पल्टाे
palaari	पलारी
palari	पलारी
pale	पले
palmonari	पलमोोररी
pulmonary	पुलमोनरी
plus	प्लस
pulse	पुलसे
pashtun	पश्तुुन
pashtuun	पश्तुून
pahan	पहन
pehan	पहन
pahantaa	पहनता
pahnata	पहनाता
pehnate	पहनतते
pahanate	पहनतते
pahante	पहनते
pehnate	पहनतते
pahnaakar	पहनाकर
pahnakar	पहनाकर
pehnakar	पहनाकर
pahnaati	पहनाती
pahnati	पहनती
pehnati	पहनती
pahani	पहनीी
pahni	पहनी
pehni	पहनी
pahno	पहनों
pehno	पहनों
pahla	पहला
pahlaa	पहला
pehla	पहला
paheliyaan	पहेलियां
paheliyan	पहेलियां
paheliyon	पहेलियों
pide	पीड़े
pied	पीडड
pythagoras	पिथागोरसस
pythogaras	पिथोगारस
paakhandi	पाखंडी
pakhandi	पखंडी
paathshaalaayein	पाठशालाएं
pathshalayein	पाठशालाएं
pathshalayen	पाठशालाएं
paathyakram	पाठ्यक्रम
pathyakram	पाठयक्रम
pathykram	पाठयक्रम
paathyakramon	पाठ्यक्रमों
pathyakramon	पाठ्यक्रमों
pathykramon	पाठयक्रमों
population	पॉपुलेशन
pailot	पैलोट
pilot	पिलोट
pailoton	पैलोटों
piloton	पिलोटों
paarampariktaa	पारंपरिितता
paramparikata	परामपारिकता
paramparikta	परामपारिकता
parnel	पर्नेल
parnell	पर्नेल
parleron	पार्लरों
parloron	पार्लोो
parlouron	पार्लरो
paarshad	पार्शद
parshad	परशाद
paarshadon	पार्शदों
parshadon	पर्शदों
parshdon	पर्शदों
policy	पॉलिसी
pinta	पिनता
pintaa	पिनता
piega	पीएगा
piyegaa	पिएगाा
pic	पिकिस
pick	पिक
pik	पीक
piki	पिकी
piky	पिक्
picture	पिक्चर
pigmentation	पिजेेेटेशन
pigs	पिग्स
pichde	पिछड़े
pichhade	पिछड़े
pijja	पिज्ाा
pizza	पिज़्ज़ा
pitaamaha	पितामाहा
pitamah	पितामह
pipra	पिप्रा
pipraa	पिप्रा
pipli	पिपली
pearson	पारसन
pierson	पियरसन
peary	पैर्य
piyari	पियारी
pisaai	पिसाई
pisai	पिसाई
pihaani	पिहानी
pihani	पिहानी
pib	पिबब
pr	प्र
pml	पिल
pmo	प्मो
pmch	पिमे
psv	स्पव
peaking	पेकिंग
picking	पिकनिंग
peetne	पीतने
pitne	पिटने
pedia	पीड़िाा
pidiya	पीढ़िया
pidiyaa	पीढ़िया
peelepan	पिलेपन
pilepan	पिलेपन
pv	प्व
pisa	पिसा
putla	पुतला
putlaa	पुतला
putaliyaan	पुतलियां
putliyan	पुतलियां
putaliyon	पुतलियों
putliyon	पुतलियों
putali	पुतली
putli	पुतली
putale	पुतले
putle	पुटले
putin	पुतिन
putul	पुतुल
punargathan	पुनर्गठन
puna	पुना
puraane	पूराने
purane	पूराने
puru	पुरु
purjon	पुर्जों
purzon	पूर्ोों
pulam	पुलम
pushkin	पुष्कीण
pushkarana	पुष्करण
pushkarna	पुष्करण
pushkarnaa	पुष्करणण
pushp	पुष्प
pushpa	पुष्प
pushpa	पुष्प
pushpaa	पुष्पा
pushpit	पुष्पित
pushpon	पुष्पों
poonjikaran	पूंजीकरण
punjikaran	पंजीीकरण
poojaapaath	पूजापाथ
poojapath	पूजापथ
pujapath	पूजापथ
pooranpur	पुरानपुर
puranpur	पुरानपुर
purvaabhaas	पूर्वाभास
purvaabhas	पूर्वभास
purvabhaas	पूर्वभास
purvabhas	पूर्वभास
pendulam	पेंडुलम
pendulum	पेंडुलम
peg	पेग
pages	पेेेस
pajej	पजेज
pace	पेस
pes	पेस
pastry	पास्ट्री
pangolin	पंगोलिन
pengolin	पेंगोलिन
packard	पैक्र्ड
package	पैकेग
packageon	पैकाजिं
packagon	पैकागों
packajon	फैकाजोो
paim	पैम्
pam	पम
paratrooper	परत्रूपर
peratrupers	पेरात्रूर्स
paranormal	परानोर्मल
peranormal	पेरेनोर्मल
paraffin	परैफीीन
parafin	पराफीनी
perafin	पेराफिन
parabola	पराबोला
perabola	पेराबोला
polimer	पॉलिमर
polymer	पॉलिमर
polishing	पुलिशशिंग
pokar	पोकर
poker	पोकर
polish	पोलिश
poshit	पोशित
posta	पोस्ता
pau	पौऊ
pyade	प्यादे
prakriya	प्रक्रिया
prakshepak	प्रक्षेपक
pratigya	प्रतिज्ञ
prtigyaa	प्रतिग्या
pratibhutiyan	प्रतिभूतियां
pratiyon	प्रतियों
prativaad	प्रतिवाद
prativad	प्रतिवाद
prativadi	प्रतिवादी
pratishat	प्रतिशत्त
praneet	प्रणीत
pranit	प्राणित
prapaat	प्रपात
prapat	प्रपत
prapaaton	प्रपातों
prapaton	प्रपतों
prabodhini	प्रबोधिनी
prayaasrat	प्रयास्त
prayasarat	प्रयसरतत
pradarshan	प्रदर्शन
prardashan	प्रदद्शन
pravati	प्रवती
pravatti	प्रवत्ती
prashaasanik	प्रशासनिक
prashasanik	प्रशासनिक
prashasnik	प्रशासनिक
prashaasanon	प्रशासनों
prashansanon	प्रशंसनों
prashasanon	प्रशासनों
prashikshu	प्रशिक्षु
prastaavon	प्रस्तावों
prastavon	प्रस्तावों
prahlaad	प्रहलाद़
prahlad	प्रहलाद़
prahasan	प्रहासन
prahsan	प्रहस्न
prahaarak	प्रहारक
praharak	प्रहरक
prahad	प्रहाद
prahlad	प्रहलाद़
privacy	प्रिवेसी
praakkathan	प्रक्ठठन
prakkathan	प्रक्ठठन
praan	प्राण
pran	प्राण
pranon	प्रणों
prathamik	प्रथमममक
prathmik	प्राथमिक
praathmikata	प्राथमिकता
prathmikta	प्राथमिकता
prathmiki	प्राथमिकी
pradhyapakon	प्रध्यापकों
prapt	प्रप्त
prapta	प्रप्ता
prapti	प्रापतत
praroop	प्ररूप
prarup	प्ररूप
priyamani	प्रियमानी
proof	प्रूफ
pruf	प्रफ
prekshakon	प्रेक्षकों
prem	प्रमम
premlata	प्रेमलताा
prema	प्रीमा
premi	प्रममी
profit	प्रोफिट
processing	प्रोसेसिंग
programers	प्रोग्रामर्स
programmers	प्रोग्रामर्स
programs	प्रोग्राम
proto	प्रोोो
propellant	प्रोपेलेंट
propellent	प्रोपेलेंट
praudh	प्रौढ़
proud	प्रोद
plan	प्लैन
plane	प्लाने
fund	फंद
funda	फुंडा
funding	फंडिंग
fandon	फंडों
fagua	फगुुा
fatane	फटनन
phatane	फटने
phatne	फटने
fadfadata	फड़फड़ता
phadphadata	फड़फड़ााा
fatehgadh	फतेहगढ़
fatehgarh	फतेहगढ़
fabti	फातती
phabti	फबती
farse	फर्स
pharase	फरसे
pharse	फरसस
farheen	फरहीन
farhin	फरहीन
farth	फार्थ
ferth	फेरथ
pharth	फार्थ
farmion	फार्मियन
fermion	फर्मिनन
firmian	फर्मियन
farookhabad	फरुखाबाद
farrukhabad	फरुखााबदद
farukhabad	फरुखाबाद
farookhnagar	फरुखनगर
farrukhnagar	फरुखनगर
farukhnagar	फरुखनगर
falata	फलता
falta	फलता
phalata	फलता
falne	फलने
phalne	फलने
falitarth	फलीतार्थ
phalitartha	फलीतार्थ
falibhoot	फलिभूत
falibhut	फलिभूत
phalibhoot	फलिभूत
favvara	फववरा
fawaara	फवारा
favvare	फववारे
fawaare	फवारे
favvaron	फववरों
fawaaron	फवारों
faisala	फैससाा
faisla	फैसला
follow	फोलो
faansi	फांसी
fansi	फैंसी
fatama	फतमा
fatma	फात्मा
faaf	फफफ
phaaph	फाफ
farsi	फरससी
forcee	फोर्स
farm	फर्म
form	फोर्
farmic	फरर्मिक
formic	फॉर्मिक
formulae	फॉर्मुलाई
formule	फॉर्म्लू
formuley	फॉर्मूल
pharmacy	फरममास्
pharma	फरमा
pharmon	फरमों
farms	फर्म्स
finger	फिंगर
fikra	फिकरा
physician	फ्यसजिििन
firti	फर्ती
fisla	फिसला
fislaa	फिसला
feeder	फीदर
fulaaye	फुलाए
fulae	फुलाएं
fulay	फुलाय
furti	फुर्ती
phurti	फूर्ती
fus	फसस
phoos	फुस
phus	फसस
feka	फेका
fefada	फेफड़ा
fefda	फेफड़ा
facial	फेसियल
fact	फैक्ट
federal	फेड़रल
failkar	फैलकर
failaaiye	फैलाइये
failaea	फैलाइा
failaiya	फैलैया
failaiye	फैलाइये
failegi	फैलेगी
font	फॉनट
fogat	फोगत
phogat	फोगत
fod	फोड
phod	फोड़
foda	फोड़ा
fodaa	फोड़ा
phoda	फोड़ा
fode	फोड़े
phode	फोड़े
fodo	फोडोो
fodon	फोड़ों
phodo	फोोोो
fortis	फोर्टिस
fusion	फुशन
fuji	फूजी
fyuji	फ्यूज
francisca	फ्रैंसिस्का
franciska	फ्रैंसिस्का
fransiska	फ्रांसिस्का
francisco	फ्रैंसिस्को
francisko	फ्रैंसिस्कों
fransisko	फ्रांसिस्को
fringe	फ्रिंग
friendship	फ्रेंडशीप
frost	फ्रोस्ट
flin	फ्लाइन
flynn	फिलंं
flesh	फ्लेश
bang	बंग
bung	बंग
bangbandhu	बंगबंधु
bangbhang	बंगभंग
bangash	बांगश
bangsh	बांगश
bantane	बंटाने
bantne	बंटने
bandhati	बंधती
bandhti	बंधती
bandhan	बंधन
bandhuon	बंधुओं
bamba	बांब
mumba	मंंब
bakaayon	बकायों
bakayon	बकायों
bakaul	बकौल
bakoul	बकोल
baksa	बकसा
baksi	बकसी
bakse	बकस
bakhshane	बख़शान
bakhshne	बख्ष्ण
bagad	बगद
bagd	बगद
bageechi	बगीची
bagichi	बगगची
bachat	बचात
bachati	बचाती
bachti	बचती
bajana	बजना
bajrangi	बजरंगी
bajaj	बजज
batalvi	बतलवी
badhachadhakar	बड़चढ़करर
badata	बड़ता
badhaataa	बढ़ता
badhata	बढ़ता
badhaati	बढ़ती
badhati	बढ़ती
badhayi	बधधायी
badhav	बधधवव
badhotari	बाधोतरी
badhotri	बाधोत्री
batlaae	बतलाए
batlaaye	बतलाए
batlae	बतलाई
batlaye	बतलाए
batlaakar	बतलाकर
batlakar	बटलाकार
badlapur	बदलापुर
badali	बदली
badli	बदली
badam	बदम
banva	बनवा
banvaa	बनवा
banaam	बनाम
banam	बनम
bnaam	बनाम
baniya	बनिया
banu	बानू
barpaayaa	बरपाया
barpaya	बरपपयया
barsa	बरसा
barsaata	बरसाता
barsaataa	बरसाता
barsata	बरसता
barhad	बरहदड़
baraat	बरात
barat	बातत
braat	ब्रत
baraamad	बरामद
baramad	बरामद
bramad	ब्रमद
baramade	बरामद़े
baramde	बरमदे
bare	बाेे
birth	बिर्थ
baljeet	बलजीत
baljit	बलजीत
ballabh	बल्लभ
balla	बल्ला
balli	बल्ली
basava	बससवा
bastiyon	बस्तियों
bahroopiya	बहरुपिया
bahrupiya	बहरुपिया
bahamaas	बहमास
bahamas	बहमास
bahaav	बहवव
bahav	बहवव
bhav	भवव
bahavalpur	बहवालपुर
bahawalpur	बहवालपुर
bahuchara	बहुचारा
banthia	बंथिया
banthiya	बांथयया
bandhate	बंधाते
bandhte	बंधते
banbi	बंबी
bombi	बोमबी
bounceron	बाउंसरों
bowling	बोललिंग
baku	बाकू
bakuu	बाकू
baag	बाग
bag	बग
bagh	बाघ
bagabani	बगबबनी
bagbani	बगगबनी
bagali	बगली
bagli	बगली
baagiyon	बागियों
bagiyon	बगियों
baago	बागो
bago	बगगो
baji	बजी
bazi	बजीी
bajaru	बजजूर
bazaru	बजजरू
bajuon	बाजूओं
badh	बधध
badha	बढ़ा
baadhaaon	बाधाओं
baadhaon	बाधाओं
badhaaon	बढ़ाओं
badhaon	बढ़ाओं
baadhit	बाधित
badhit	बधितत
baani	बानी
bani	बनन
baapa	बापा
baapaa	बापा
bapa	बापा
bapaa	बापा
baabat	बाबत
babat	बबत
babt	बबत
bayern	बायर्न
byrun	बारून
barah	बारह
baarahamaasee	बारहमासी
barahamasi	बरहममासी
barahmasi	बरहम्ससी
barahsinga	बारहसिंगा
barasingha	बाससिंहा
bala	बला
baalti	बालती
balti	बलती
balty	बाल्टी
baldvin	बाल्वीी
baldwin	बाल््ीी
bavaji	बावजी
bavji	बावजी
baawaraa	बावरा
bavra	बावरा
bawara	बवारा
baahulya	बाहुल्य
bahuly	बहुल्य
bahulya	बहुल्य
box	बोक्स
bikherati	बिखेरती
bikherti	बिखेतीी
biggest	बाग्सेट
bichhua	बिछुआ
bichhuaa	बिचुआुआ
biji	बिजी
busy	बस
buzy	बेजी
bipin	बिपिन
bilae	बिलाएं
bilai	बिलाई
billa	बिल्ला
billaa	बिल्ला
bilhaur	बिल्ौौर
bisva	बिस्व
biswa	बिस्वा
bag	बग
bikaner	बिकनर
bikaneri	बिकनेरी
bk	बेके
beejak	बीजक
bijak	बिजक
beef	बीफ
beem	ीीम
bim	बिम
beemon	बीमों
bimon	बिमों
beerganj	बीरगंज
birganj	बीगगंज
beesavaan	बीसवां
bisavan	बिसववं
bisawan	बिसववन
beast	बेस्ट
budvig	बुदववग
budwig	बुडवीग
bull	बलल
bulaao	बुलाओं
bulao	बुलाओं
bule	बुले
bulletin	बल्लेटिन
brijesh	बृजेश
benvar	बेनवर
benwar	बेनवर
beaulad	बेयलाद
bekaaboo	बेकाबू
bekabu	बेकबू
bechakar	बेचकरर
bechkar	बेचकर
bechate	बेचते
bechte	बेचते
bediyan	बेडियां
bethanal	बेथनाल
bethnal	बेथनाल
benis	बेनिस
belacha	बेलचा
belcha	बेलचा
belinda	बेलिंदा
bevkufana	बेवकूफना
bewakoofaanaa	बेवकूफाना
bewkufana	बेवकूफना
besahaaraa	बेसहारा
besahara	बेसहरा
basin	बसीन
besin	बेसिन
basil	बससल
besil	ेेसिल
bandage	बंदगे
bandej	बंदेज
baithantey	बैठंते
baithate	बैठते
baitool	बैटूल
baitul	बैतुल
betul	बेतुल
baini	बैनी
beni	बेनी
bairakpur	बैरकपुर
barrackpore	बैराककपरर
baila	बैला
bella	बेला
ballistic	एल्लिस्टिक
bells	बेल्स
bostan	बोस्टन
bosten	बोस्टन
boston	ोोस्टन
bokaro	बोकरों
bodara	बोदरा
bodra	बोद्रा
bodraa	बोद्रा
bona	बोना
borkar	बोरकर
borivali	बोरीवाली
boriwali	बोरिवाली
born	बोर्न
bolane	बोलने
boliae	बोलियाई
boliy	बोलिय
boliye	बोलिय
bosaan	बोसन
bosan	बोसन
bauni	बौनी
bouni	बौनी
byaawa	ब्यावा
byavar	ब्यावर
brajesh	ब्रजेश
brijesh	बृजेश
brahmalin	ब्रह्मालिन
brahmleen	ब्रह्मलीन
brahmlin	ब्रह्मलिन
bravo	ब्रेवो
brigatn	ब्रिगटन
brighton	ब्राइटों
brigton	ब्रगटन
brigadier	ब्रगिडरय
britain	ब्राटेटन
breed	ब्रीद
brock	ब्रॉक
brok	ब्रोक
broke	ब्रोक
brocken	ब्रॉकेन
broken	ब्रोकन
blosam	ब्लोसम
blossom	ब्लोसम
bhagaane	भगाने
bhagane	भगगन
bhadakaaya	भड़काया
bhadakaya	भड़काया
bhadkaayaa	भड़काया
bhadkaya	भड़काया
bharakaaya	भरककाया
bharakaya	भरककाया
bhabhoot	भभूत
bhabhut	भभभूत
bhay	भयय
bhaya	भाया
bhayo	भययो
bharatanatyam	भारतनात्यम
bharatnatyam	भारतनात्यम
bhartnatyam	भारतनात्यम
bharate	भड़ते
bharte	भरतते
bharani	भरणी
bharni	भाणी
bharane	भरनन
bharne	भरने
bhara	भाा
bhavishya	भाविष्य
bhaate	भाते
bhate	भाते
bhanu	भानु
bhabar	भाब
bhareeye	भाीी
bhariy	भारीय
bhavanaon	भवनाओं
bhavnaon	भावनाओं
bhaskar	भसस्कर
bheed	भीड
bheera	भीरा
bhira	भिरा
bheesham	भीष्म
bhisham	भिक्म
bhishm	भिश्म
bhugat	भुगत
bhugata	भुगता
bhugta	भुगता
bhutto	भूत्तों
bhumi	भूमि
bhurbhura	भुरभुरा
bhookh	भूख
bhukh	भूख
bhookhi	भूखी
bhukhi	भुखी
bhoogol	भूगोल
bhugol	भगगुल
bhootal	भूताल
bhutal	भूताल
bhoopsingh	भूपसिंह
bhupsingh	भूपसिंह
bhumi	भूमि
bhumika	भूमिका
bhulata	भुलता
bhulataa	भुलता
bhulta	भुलता
bhula	भुला
bhulaa	भुला
bhooli	भूलि
bhuli	भुलि
bhulo	भुलों
bhulon	भूलों
bhusi	भूसी
bhooswaami	भूस्वामी
bhusvami	भूस्वामी
bhuswami	भूस्वामी
bhengapan	भेंगपन
bhairavnath	भैरववनाथ
bhairo	भैरो
bhogatey	भोगते
bhogte	भोगते
bhola	भोला
bholi	भोली
bholu	भोलू
bhaunho	भौनोों
bhaunhon	भौनंों
bhoonhon	भूनों
bhraant	भ्रांत
bhrant	भ्रंत
brant	्रंटट
bhraanti	भ्रांति
bhranti	भ्रांीी
branti	ब्रांटी
bhraantiyan	भ्रांतियां
bhrantiyan	भ्रांटियां
bhraantiyon	भ्रांतियों
bhrantiyon	भ्रांतियों
mangesh	मंगेश
manch	मंच
manchit	मानचित
mancheeye	मंचचीय
manchiy	मांचीय
manchiya	मांचिया
manchon	मंचों
manjil	मंजील
manzil	मंजल
manjila	मंजीला
manzila	मंजिला
manjilein	मंजजलल
manjilen	मंजजलें
manzilein	मंजजलल
manto	मंतो
mantriyon	मंत्रियों
makrani	मकररनी
maksad	मकसद
makhdumpur	मखदुपुर
machaaye	मचाए
machae	मचाई
machaye	मचाये
machaanon	मचानों
machanno	मचननों
machano	मचनों
machanon	मचनों
madaura	मदौरा
madhuara	मधधुरा
madhura	मधधररा
manipal	मनिपाल
matpatron	मतपत्रों
matthe	मत्थे
matsyavatar	मत्स्यवा््
matsyavtar	मत्य्यव््र
masyendranath	मस्येंद्रनाथ
matsyendranath	मत्सेंद्रनाथ
madhupur	मधधपुर
manmarji	मनमर्जी
manae	मनाई
manaye	मननय
mnaey	मनाई
mam	मम
mum	मम
maryokar	मरयोोकर
mayorka	मयोरका
mayorkaa	मयोरका
mardaani	मर्दानी
mardani	मर्दानी
marmar	मरमर
murmur	मुरमूर
maratha	मरथा
marathi	मरथथी
marji	मरजी
mardanagi	मर्दनागी
mardangi	मर्दंगी
mardo	मार्दो
mardon	मरदों
maryaadaa	मर्यादा
maryada	मर्यदा
maryaadaaon	मर्यादाओं
maryadaon	मर्यदाओं
malaga	मलगा
malaar	मलार
malar	मललर
mashrak	मशर्क
masaaledaar	मसालेदार
masaledaar	मसलेेाार
masaledar	मसलेदार
masoor	मसूर
masur	मसूर
masse	मसे
mahakane	महाकनने
mahakne	महाकने
mahkane	महकाने
mehkane	महकनने
mahalon	महलोों
mahlon	महलों
mahagranth	महाग्रंत
mhagranth	महगग्रंथ
mahajan	महाजन
mhajan	महाजन
mahathir	महाथिर
mhathir	महाथिर
mahanatam	महानतम
mahantam	महानतम
mhantam	हमाततम
mahanideshak	महानिदेशक
mahanirdeshak	महानिर्देशक
mhanideshak	महानिदेशक
mahapauron	महापूरों
mhapauron	महापौरों
mahapran	महाप्रण
mhapran	महाप्रण
mahamantr	महामंत्र
mahamantra	महामंत्र
mhamantra	महामंत्र
maharaja	महराजा
mahavigyan	महाविज्ञान
mhavidyan	महाविद्ञान
mahavidya	महाविद्य
mhavidya	महाविद्या
mahavishnu	महाविष्णुता
mahasingh	महासिंह
mahasinh	महासिंह
mahipal	महिपाल
mahin	महहिन
mahinon	महिनों
maang	मागग
mang	मंग
mangani	मंगानी
mangni	मंगनी
maanga	मांगा
manga	मंगा
maangi	मांगी
mangi	मंगी
maange	मांगे
mange	मंगे
mango	मंगो
maori	मोोी
maajin	माजिन
majin	मजीन
mathe	मठेे
mathey	मथेे
maap	माप
map	मपप
mop	मोप
mamooli	ममूली
mamuli	मममली
mame	मेे
maarvaad	मारवाद
marvad	मारवाद
marwar	मरवार
maariya	मररया
mariya	मरिया
maariyo	मारियो
mario	मररियो
mariyo	मरियो
martha	मररथा
maalish	मालिश
malish	मललीश
mave	मेव
mavey	मावे
maas	मास
mas	मस
mass	मस
maason	मससों
mason	मसों
mitaao	मिताओं
mitao	मिताओं
mithaai	मिथाई
mithai	मिथाई
media	मीडिया
mithila	मिथिला
mithilanchal	मिथिलंचल
mithya	मिथ्य
mimicry	मिमिक्री
milkiyat	मिलकियत
misha	मिशा
mungeri	मुंगेरी
mundva	मुंडवा
mundwa	मुंडवा
munshiganj	मुंशिगंज
mukarte	मुकररते
mukartey	मुकारते
mukhopadhyaya	मुखोपाध्यय
mukhyopadhyaay	मुक्योपाध्याय
mukhyamantri	मुख्यमंत्री
munaf	मुनफ
munafa	मुनफा
munnu	मुन्नु
mufalisi	मुफलिसी
muflisi	मफल्सीी
mubarakpur	मुबराकपुर
mubarkpur	मुबरकपुर
murjha	मूर्ा
multae	मुलताएं
multai	मुलताई
mushahid	मुशाहदद
muhavare	मुहावरे
muhavre	मुहावरे
mooth	मूठ
muth	मठ
mood	मूद
mud	मउद
moodi	मूदी
moody	मूड्य
mool	मूल
mul	मूल
moolchand	मूलचंद
mulchand	मूलचंद
moolar	मूलर
mular	म्यूर
muller	मललर
moolon	मूलों
mulon	मूलों
maxico	मैक्सिको
mexico	मैक्सिको
mega	मेगा
megapixal	मैगैपिक्सल
megapixel	मैगैपिक्सल
mejbaan	मेजबान
mejban	मेजबान
mezbaan	मेजबान
mejabani	मेजबानी
mejbaani	मेजबानी
mejbani	मेजबानी
mezabani	मेजबानी
mejbaan	मेजबान
mejban	मेजबान
mezbaan	मेजबान
mejbaani	मेजबानी
mejbani	मेजबानी
mezbaani	मेजबानी
mate	मेे
met	मेट
mates	मेट्स
medical	मैडिकल
methanol	मेथनॉल
menu	मेनु
mem	मम
melaghaat	मेलाघाट
melghat	मेलघाट
melaanin	मेलानिन
melanin	मेलानिन
melaani	मेलानी
melani	मेलननी
maheman	महेमान
mehamaan	मेहमान
mehaman	महम्न
mehmaan	मेहमान
mehman	महम्न
meharaam	मेहराम
mehram	मेहराम
macbook	मकबूक
matix	मेटिक्स
matrix	मेट्रिक्स
mad	मद
made	मडेे
maid	मैद
maddy	मेड्
maidi	मैदी
main	मेन
man	मन
men	मेन
mainan	मैनान
menon	मेनों
manner	मननर
maina	मैना
maine	मैने
marrej	मरेेज
marriage	मैरिएज
merraige	मैरेज
maisachusets	मेसाचुसेट्स
massachusetts	मेसाचुसेट्स
maisor	मैसोर
maisore	मैसोर
mysore	मैसोर
mod	मोद
mode	मोद़े
modern	मोडरन
module	मोदलल
modules	मोडललस
modyuls	मॉडयुल्स
mauritious	मॉरीशश
mauritius	मॉरीशस
mogali	मोगली
mowgli	मोगली
motive	मोटिवे
mol	मोल
mold	मोल्ड
moshe	मोशे
mosad	मोसद
mohana	मोहना
mohani	मोहनी
mohini	मोहिनी
mohim	मोहिम
maukon	मौकों
mauma	मौमा
maurya	मौर्या
morya	मोरया
maurya	मौर्या
mauryon	मौरियों
moryon	मोरियों
maulaviyon	मौलवियों
maulvidon	मौलविदों
maulviyon	मौलवियों
maule	मौले
mauley	मौले
mausa	मौसा
yatn	यतन
yatna	यतना
yada	यादा
yda	यदाा
yaduvansh	यदुवंश
yaduwansh	यदुवंश
jerusalem	जेरसलम
yarooshaleim	यररुशामि
yarushalem	यरुशाम
yashpaal	यशपाल
yashpal	यशपाल
yaatna	यातना
yatna	यतना
yaatanaon	यातनाओं
yatnaon	यतननाओं
yarayan	ययाान
yatraein	यात्राएं
yatraen	यात्राएं
yaariyan	यारियां
yariyan	यारिया
yaari	यारी
yari	यारी
yugam	युगम
yugm	यगग्
yuddhrat	युद्धरत
yudhrat	युद्रत
ukrainian	उक्रेनीन
ukranian	उक्ररनियां
jerusalem	जेरसलम
yorker	योर्कर
yojanaein	योजनाएं
yojanaen	योजनाएं
yojanaye	योजनाए
rangate	रंगते
rangte	रंगते
rangkata	रंगकता
ranjkatha	रंजकठा
ranjkta	रणजकतत
raees	रीस
rais	रैस
raktaabh	रक्ताभ
raktabh	रक्तभ
rakhna	रखना
raghupati	रघुपति
raghuram	रघुराम
registerd	रजजि््््ड
registered	रजिस्टर्ड
ratanpur	ततनपुर
runners	ररनर्स
rayan	रायन
ryan	रयान
ralhan	रहहण
ravish	राविष
ravael	रवाल
ravel	रवेल
rawail	रवेल
rasad	रसाद
rasaayanik	रसायनिक
rasaayanika	रसायानिका
rasayanika	रसायननिक
rasyanik	रास्यनिक
rasaayanon	रसायनों
rasayanon	रसायनों
rahamat	रहमत
rahmat	रहमत
rhamat	रहमत
rahenge	रहेंगे
rahegi	रहेगी
rounder	रंड्रर
raak	रक
rak	रक
raakhe	रखे
rakhe	रखे
raagon	रगगों
ragon	रगों
raghavan	रघवन
raaj	राज
raj	रज
rajkot	राजकोत
rajtantra	रजतंत्र
raajneetikaran	राजनीतीकरण
rajneetikaran	राजनीतीकरण
rajnitikaran	रजजनीतकरण
rajma	रजजा
rajman	रजजमन
raajasva	राजस्व
rajasva	रासस्व
raaji	राजी
raji	रजज
rajinaama	राजीनामा
rajinama	राजीनमा
raajon	राजों
rajon	रजोो
rana	रणा
raatrichar	रात्रिचार
ratrichar	रत्रिचार
raadhe	राधे
radhe	राधे
ranapur	रानापुर
rabin	रबीन
robin	रॉबिन
rabha	रभा
ramkot	रामकोत
ramkote	रामकोत
ramtek	रामतेक
rampur	रामपुर
rambharose	रामभरोसे
rambharosey	रामभरोसीय
ramraj	रामृाज
raalod	रालोद
ralaud	रालौद
ralod	रालोद
ravaley	रवाले
ravle	रावले
rasayanik	रससायनिक
racreation	रैक्रिएन
recreation	रिक्येशन
rig	गिग
riggs	रिग्स
rigs	रिग्स
richual	रिचुआल
ritual	रितुअल
reduction	रेडक््शन
ripan	रिपण
ripon	रिपोो
ria	रिया
riya	रिया
rishte	रिश्ते
rishtey	रिश्ते
risane	रिसने
risaney	रिसने
risne	रिसने
rihana	रिहना
rihanna	रिहन्न
regal	रेगल
rigal	रिगल
reasonal	रिजनन
regional	रिजनयनल
retreate	रिट्रेट
retweet	रेतवीत
reeta	रीता
rita	रीता
rukate	रुकते
rukte	रुकते
ruktey	रुकते
rugan	ृग्ण
rugna	रूग्ण
ruganta	रुगंता
rugnata	रुग्तता
rojvelt	रॉजवेल्ट
roojwelt	रूजवेल्ट
roosevelt	रॉजवेे्ट
rodolph	रोडोल्फ
rudolf	रुडोल्फ
rudolph	रोडोल्फ
roopesh	रुपेश
rupesh	रूपेश
ruby	रूबी
roomani	रूमानी
rumani	रूमानी
rukavaton	रुकावटों
root	रुट
route	रुट
rooting	रूटिंग
routine	रुटिनन
routing	रुटिंग
roots	रुट्स
routes	राटेस
roopak	रुपक
rupak	रूपक
roopi	रुपी
rupi	रुपी
rantle	रांतल
rental	रेंटाल
registan	रेिि्टान
registani	रेजि्टानीी
reja	रेजा
reza	रेजा
rate	रतेे
rate	रतेे
ret	रेट
refaeli	रफफाली
refeli	रेफेली
reshe	रशशे
reshey	रेशे
race	रेस
rese	रीसी
racer	रेसर
recer	रीसर
racing	रेसिंग
reson	रेसों
rehaana	रहहना
rehana	रहहाा
racketeer	रेकेटीर
racketier	रैकेटियर
rectare	रिक्टारे
radical	रेडिकल
raidical	रेडिक्सल
raith	रैठ
rapping	रैपिंग
wrapping	रैपपििग
robertsan	राबर्ट्सन
robertson	रोबर्ट्सन
robinson	रोबिंसन
royals	रॉयल्स
rojlin	रॉजलिन
rozlyn	रोजलिन
rotation	रोटेशन
rodrigo	रोड़िगो
ronaldo	रोनाल्डो
ronit	रोनित
roni	रोनि
ropane	रोपने
ropaney	रोपने
ropne	रोपने
robin	रॉबिन
roya	रोया
rollers	रॉलर्स
rovan	रववन
rowan	रोवन
rosario	रोसरियो
rosariyo	रोसरियों
raubadaar	राबदार
raubadar	राबदर
raubdar	राबदार
landara	लंदारा
langada	लंगदा
langda	लंगदा
langar	लंगर
langaron	लंगारों
langron	लंगरों
lambi	लंबी
lakeer	लकीर
lakir	लकीर
lakiron	लकीरों
lakme	लक्म
lakshmidhar	लक्ष्मीधार
lakshmighar	लक्ष्मीघार
lakshy	लक्ष्य
lakshya	लक्ष्य
lakshyon	लक्ष्यों
lux	लक्स
laksar	लक्सर
luxor	लक्सर
lakhkhi	लख्खी
lagna	लगना
laganewale	लगनेवाले
lagnevaaley	लगनेवाले
lagnewale	लगनेवाले
lagega	लगेगा
lajjalu	लजजलू
latkate	लटकते
ladki	लड़की
ladate	लड़ते
ladte	लड़ते
ladaai	लड़ाय
ladai	लड़ाई
ladaaiyon	लड़ाईयों
ladaeyon	लड़ाययों
ladaiyon	लड़ाइयों
lapetane	लपेटने
lapetne	लपेटने
labada	लाबदा
lbada	लबददा
labdh	लाबद
lbdh	ललद्ध
lalak	ललकक
lalkarata	ललककरता
lalkarta	ललककर्ता
lalla	ललला
lavasa	लवासा
lovasa	लोवसस
lassi	लससी
lahanaa	लहना
lahna	लहना
lehna	लहना
lahraee	लहराई
lahrai	लहरायी
lehrayi	लहरायी
lahalhati	लहलहाीी
lahlahaati	लहलहहती
lahlahati	लहलहहीी
lahsun	लाहसून
lasoon	लसून
lanchar	लांचर
launcher	लॉन्चर
lycopene	लाकोपपे
lime	लामम
lives	लिवेस
live	लीवव
laegi	लागी
lagataar	लगतार
lagatar	लगतरर
laata	लाता
lata	लता
laati	लाति
lati	लति
layega	लाएगा
lalpur	ललपपुर
las	लास
last	लस्त
lindbhed	लिंभदेद
lingbhed	लिंगभेद
lindan	लिंडन
lindn	लिंडन
lindon	लिंडों
likhakar	लिखाकार
likhkar	लिखकर
ligar	लिगर
liger	लाइजर
liberation	लाइबेरेशन
libration	लाइब्रेशन
liberation	लाइबेरेशन
libration	लाइब्रेशन
leaderon	लीडरों
leedaron	लीडारों
lidaron	लीदारों
liidaron	लीीडरों
louis	लोइस
luis	लुईस
ludhakate	लुढ़कते
ludhkate	लुढ़कते
lurhakate	लुरककते
lutf	लटफ
lumding	लमडिंग
lootmaar	लूतमार
lootmar	लूतमार
landal	लंडाल
lendal	लेंडाल
lega	लेगा
legaa	लेगा
letakar	लेटाकर
letkar	लेटकर
lenevali	लेनेवाली
lenewali	लेनेवाली
label	लेबल
labeling	लेबेलिंग
labelling	लेबिलिंग
labelo	लेबेलो
labelon	लेबेलों
lebalon	लेबललं
lemon	लममन
laingadan	लैगगड़न
langdon	लंगडोो
lengdan	लेंगडन
laigikata	लैगिकता
laingikta	लैंगिकता
lanset	लांसेट
lenset	लेस्ेेट
lairi	लैरी
lairy	लेरी
larry	लैरी
lace	लेस
less	लेस
locket	लॉकेट
laundry	लॉट्ड्री
longewal	लोंगेवाल
longewala	लोंगेवाला
longoval	लोंगोवाल
log	लोग
loge	लोज
lochdar	लोचड़र
lodi	लोदी
laurence	लारेंसस
laurens	लारेंस
laurense	लारेंस
wonder	वंडर
vansh	वंश
vanshdhar	वंशधरर
vanshavad	वंशावाद
vanshvaad	वंश्वाद
vanshvad	वंश्वाद
wanshwad	वंश्वाद
vajood	वजजदद
vajud	वजजूद
wajood	वजूद
vadali	वादली
vadli	वादली
wadali	वादली
vanita	वानिता
vareinye	वररीन
varenya	वारेनाया
varn	वर्ण
varna	वर्ण
varnit	वर्नित
vartamaan	वर्तमान
vartaman	वर्तमान
vartmaan	वर्तमान
vartman	वर्तमान
varddhaman	वर्दधमान
vardhmaan	वर्धमान
vardhman	वर्धमान
verbal	वर्बल
varshan	वर्षण
vasharan	वशररण
vershan	वर्षण
version	वर्सिन
varsaache	वरससाचे
varsaryache	वरसर्यचची
vasearche	वसरर्च
valkan	वालकक
valkkan	वाक्कण
velkan	वेलकन
vash	वशश
vashikaran	वाष्पीकरण
vaangchuk	वांगुुक
vangchuk	वंगचुकक
wangchuk	वंगचुक
want	वंत
vije	विजे
vise	वीजे
wise	वासे
vatar	वातर
water	वाटर
watson	वतसस
wattson	वत्सस
vaan	वान
waan	वान
vaanon	वानों
vanon	वनों
wanon	वनों
vatanukulan	वातानुकूलन
watanukoollan	वातानुकूलनन
vaadak	वादक
vadak	वददक
vaadiyon	वादियों
vadiyon	वादियों
wadiyon	वादियों
vayana	वायना
vayna	वायना
wayna	वायना
wireless	वायरलेस
wirerless	वररलेेस
warrior	वेरियर
warriors	वेरियर्स
valve	वालव
wolv	वललव
vastavik	वास्तववकक
vastvik	वास्तविक
vaahikayen	वाहिकाएं
vahikayen	वाहिकाएं
wahikayan	वाहिकाया
winter	विंटर
vincent	विंसेंट
vikalpon	विकल्पों
wicket	विकेट
vikramjeet	विक्रमजीत
vikramjit	विक्रमजित
vichaarakon	विचारकों
vicharakon	विचारकों
vigyan	विज्ञान
vigyaani	विज्ञानी
vigyani	विज्ञानी
vigyaanon	विज्ञानों
vigyanon	विज्ञानों
vitthal	वित्थल
viththal	विथताल
vitthal	वित्थल
vitark	वितरक
vidhaaein	विधाएं
vidyaayein	विद्यायं
vidyaen	विद्याएं
vidhaaon	विधाओं
vidyaaon	विद्याओं
vidyaon	विद्याओं
vidhansabhaein	विधानसभाएं
vidhansabhaen	विधानसभाएं
vidhivat	विधिवत्
vidhut	विद्धुत
vinasht	विनाश्त
vineet	विनीत
vinit	विनित
vipreetataa	विप्रीतता
vipritata	विपरितता
vipra	विप्र
vipro	विप्रो
wipro	विप्रो
vibha	विभा
vibhajak	विभाजक
vibhram	विभर्म
vibhrm	विभर्म
vibram	विबर्म
vimarsh	विमर्शश
vimarsho	विमारशशो
vimarshon	विमार्शों
virajati	विराजाि
virechan	विरेचन
virodh	विरोध
virodhabhasi	विरोधााासी
virodhabhason	विरोधाासों
vividh	विविध
vivekahin	विवेकाहीन
vivekheen	विवेखीन
visheshan	विशेषण
visheshanon	विशेषाों
visheshaadhikaar	विशेषाधिकार
visheshadhikar	विशेषाधिकार
vishwasaniy	विश्वसानीय
vishwasniiya	विश्वसनीीय
vishwasaniyata	विश्वसननीयता
vishwasniiyataa	विश्वसननीयता
vishahin	विशाहीन
vishhin	विश्नी
vishanu	विषाणु
vishnu	विश्णु
vlc	वल्क्
weeks	वीक्स
veerchand	वीरचंद
virchand	वरचचंद
veeresh	वीरेश
viresh	विरेश
vritton	वृत्तों
vruton	वृतों
vrutton	वृत्तों
venkataraman	वेंकटरमण
venkatraman	वेंकटरमण
ved	वेद
wade	वादे
wed	वेद
wedding	वेडिंग
vediyon	वेदियों
vedon	वेदों
venezuela	वेनेजुला
veronica	वेरोनिका
veronika	वेरोनिका
weronika	वेरोनिका
velvet	वेलवेट
welwet	वेलवेट
welder	वेल्डर
weldor	वेल्डर
welding	वेल्डिंग
wealth	वेल्ट
vellur	वेलुर
velur	वेलूर
vesh	वेश
wasting	वास्टिंग
westing	वेस्टिंग
wastinghouse	वस््टिनघाइस
westinghouse	वेस्टिंघाइस
vaisley	वैसलले
vesle	वेसलल
wesle	वेजल
vaigyaanik	वैज्ञानिक
vaigyanik	वैज्ञनिक
vegyanik	वेग्ञानिक
vaigyaanikta	वैज्ञानिकताा
vaigyanikata	वैज्ञानिकताा
vaigyanikta	वैज्ञानिकता
vaitravati	वैत्रावती
vaitrawati	वैत्रावती
vaimanasy	वैमानस्य
vaimanasya	वैमानस्या
vaimanya	वैमान्य
very	वररी
vaisaakh	वैसाख
vaishakh	वैशाख
vaishaakhi	वैशाखी
vaishakhi	वैशाखी
vaishnodevi	वैष्णोदेवी
vyaktigat	व्यक्तित
vyagr	व्यगरर
vyagra	व्याग्रा
vyatit	व्यतित
vytit	व्यतित
vyabhichar	व्यभीचचरर
vyabhichari	व्याभिचारी
vyavadhan	व्यवधान
vyavdhan	व्यावधान
vyavahargat	व्यवहारगत
vyvhargat	व््यवरगगत
vyaghat	््याघात
vyapak	््यापक
vlad	व्लद
wlaad	वलाद
vladimir	व्लादीमिर
shanghai	शंघााई
shatpath	शतपपथ
shanivar	शानीवरर
shaniwar	शननीवरर
shabana	शबना
shbana	शबनना
shabdarth	शब्दार्थ
shamadan	शमजदन
shmadan	शमददन
shamitabh	शमीततभ
shamil	शममिल
shmil	शममिल
sharabon	शराबों
shrabon	श्रबों
shararat	शरारत
shrart	शरातत
sharmana	शर्मना
shaharwasiyon	शहरववासियों
shahrvasiyon	शहरववासियों
shervasiyon	श्रवासियों
shahdara	शहाारा
shaantikaal	शांतिकाल
shantikal	शांतिकाल
shaao	शाओ
shao	शाओ
shaakir	शाकीर
shakir	शाीीर
shaakhaaen	शाखाएं
shakhayan	शखखायन
shakhayen	शखखाएं
shayak	शायक
shaavakon	शावकों
shavakon	शावकों
shavkon	शावकों
shaasaka	शासका
shasak	शासक
sasakon	ससकों
shaasakon	शासकों
shasakon	शासकों
shipra	शिप्रा
shirke	शिरके
sheershakon	शीर्षकों
shirshakon	शीर्षकों
shirshkon	शीर्षकों
shujaat	शुजात
shujat	शुजात
shooting	शूटिंग
shutting	टटटिंग
should	शाल्ड
shud	शुद
shubhankar	शुभंकर
shumaali	शुमाली
shumali	शुमाली
shringaar	श्रृंगार
shringar	श्रृंगार
shrungar	श्रुंगार
sheling	शेलेंग
shelling	शेल्लंग
shaili	शैली
shaly	शल्य
sheli	शेली
shaishav	शैशाव
sean	सीन
shaun	शौन
shawn	शव्न
short	शोर्ट
sure	सुरे
shrankhala	श्रृंखला
shrankhalaa	श्रृंखला
shrunkhla	शृंखला
shrankhalaaon	श्रृंखलाओं
shrinkhalaon	श्रृलाओंाओं
shrunkhlaon	शृंखलाओं
shravani	श्रवनी
shrikar	श्रीकार
shrikhand	श्रीखंड
shrimati	श्रीमती
shriram	श्रीरमम
sriram	श्रीराम
shrotaon	श्रोताओं
shat	क्त
sankhyaein	संख्याएं
sankhyaen	संख्याएं
sankhyayen	संख्याएं
sanghanit	संघानित
sanghnit	संघननत
sanchayan	संचायन
sanchar	संचरर
sanchaari	संचारी
sanchari	संचारी
sanchalanon	संचलनों
sanchalnon	संचलोों
sanjay	संजय
sanjeevan	संजीवन
sanjivan	संजीवन
santati	संततती
sandarbh	संदर्भ
sandarbha	संदर्भ
sandrbh	संद्रभ
sandarbhon	संदर्ों
sandrbhon	संद्रों
sandali	संदली
sandli	संंली
sandhan	संधन
samprati	संप्रति
samprti	संप््ती
samprabhu	संप्रभु
samprbhu	संपर्भ
samprabhuta	संप्रभूता
samprbhuta	संप्रभुता
sambit	संबित
sambhalane	संभालने
sambhalne	संभालने
sambhrant	संभ्रतत
sanbharnt	संभारतत
sanyog	संयोग
sanyukt	संयुक्त
sanyukta	संयुक्त
sanyukta	संयुक्त
sanyogvash	संयोग्वश
sanyojan	संयोजन
sanyojanon	संयोजनों
sanyojnon	संयोजनों
samvedikaran	संवेदीकरण
sanvedikaran	संवेदीकरण
samshayon	समशयययं
sanshayon	संशायों
sanshyon	संश्यों
sanskaar	संस्कार
sanskar	संस्कर
sanskaari	संस्कारी
sanskari	संस्कार
sanskrit	संस्कृत
sanskurt	संस्कृत
sanskritiyan	संस्तुतियां
sanskrutiyan	संस्तृतियां
sanskritiyon	संस्तुतियों
sanskrutiyon	संस्तृतियों
sanasthit	संस्थित
sansthit	संस्थित
sanasthita	संस्थिता
sansthita	संस्थिता
sakara	सकााा
sakra	सक्रा
sakshan	सक्षण
suction	सक्शन
sacchidanand	सच्चिदानंद
sachhidanand	सच्चिदानंद
sachidanand	सचिदिनंद
sajja	सज्जा
sat	सत
satpal	सत्पल
satluj	सतलूज
sataane	सताने
satane	सताने
sate	सते
satti	सत्ती
satvat	सत्वत
sadanand	सदानंद
sapane	सपनन
sapne	सपने
sapney	सपपनय
saparivaar	सपरिवार
sapariwar	सपरिवार
sparivar	स्परिवार
sapaat	सपात
sapat	सपत
sapate	सपतते
sapatey	सपतते
saptakranti	सप्तक्रांति
saptkraanti	सप्त्र्ंतति
saptapadi	सप्तपदद
saptpadi	सप्तपदद
saptari	सप्तरी
sapramaan	सप्रमाण
sapraman	सप्रमण
submit	सबममत
sabmission	सब्मिशन
submission	सब्मिशन
sabhaein	सभाएं
sabhaen	सभाएं
sabhayen	सभाएं
sabhen	सभें
sabhasadon	सभासददों
sabhyata	सभ्यता
samjhoonga	समझूंगा
samjhunga	समझुगा
samjhungaa	समझुंगा
saman	सामन
samanvayaka	समन्वययक
samanwayaka	समन्वयका
samnvyak	समन्वययक
samaadhaan	समाधान
samadhan	समधधन
samadhiyon	समाधियों
samadjiyon	समादजियों
samalakha	समलखा
samalakhaa	समलखा
samahaar	समाहार
samahar	समाहर
samitiyan	समितियां
sametati	समेतती
sametti	समेतती
sarka	सरका
sarkaa	सरका
sarkarein	सरकारें
sarkaren	सरकरें
sarkaaron	सरकारों
sarkaron	सरकारों
sargana	सरगनना
sarganaon	सर्गनाओं
sargi	सरगगी
sarguja	सरगुाा
sarjuga	सर्जगा
sarsa	सरसा
sarsaa	सरसा
sarahind	सराहींड
sarhind	सरहींद
sirhind	सिरहिंड
saraaha	सराहा
saraha	सरहहा
saraahi	सरााी
sarahi	सरराही
salaahkar	सलाहकरर
salahkaar	सलाहकार
salahkar	सलाहकरर
saleeb	सलीब
salib	सलीबब
select	सेलेक्ट
saltanat	सल्टानत
saltnat	सल्टनात
savaal	स्वाल
saval	स्वाल
sawaal	स्वाल
sawal	स्वाल
sahakalaakar	सहकालाकर
sahakalakar	सहकालकरर
sahkalakar	सहकललकरर
sahadev	सहादेव
sahdev	सहदेव
sahrawat	सहरावत
sherawat	शेरावत
sahooliyata	सहूलियता
sahuliyat	सहूलियत
sahuuliyata	सहूलियता
saanketika	सांकेतिका
sanketik	संकेटिक
saimans	साममंस
simmons	सीममंंस
symons	सायमॉं्स
saima	साममा
sagarika	सगरीका
sagrika	सगरीका
saga	सगा
saajan	साजन
sajan	सजान
saajsajja	सससजजजा
sajsajja	ससजजजा
saja	सजा
saathsaath	साथसाथ
sathsath	सतथस्थ
sathiya	साथिया
saabah	साबाह
sabah	सबाह
samanjasy	समांजस्य
samanjasya	समांज्या
samoa	समोा
samoaa	समोा
saayn	सायन
sayan	सायन
saym	साम्
saira	सैरा
sayara	सायरा
sayra	सायरा
salve	सलवव
sahab	सहबब
singapore	सिंगपौर
singaar	सिंगार
singar	सिंगर
singer	सिंगर
singhaadey	सिंहादे
singhade	सिंहदेड
singhde	सिंहदे
singhre	सिंहरे
singhi	सिंघी
singha	सिनघा
sinha	सिन्हा
siera	सियरा
sierra	सियरा
sikud	सिकुड़
signals	सिगनलल्स
cigaretton	सिगरेटटों
cigretton	सिग्रेटन
siddhivat	सिद्धिवत
siddhvat	सिद्धवत
siddhwat	सिद्धवत
sinabang	सिनाबंग
synapse	सिनेप्स
sipah	सिपफ
sipaha	सिपहाा
sipahiyon	सिपहिियों
sipahi	सिप्फी
sim	सिम
simat	सिमत
simatataa	सिमतता
simatta	सिमतता
simtata	सिमतताा
simtataa	सिमतता
cement	सेमेंट
simate	सिमेट
simi	सिमी
simmy	सिम्मी
sims	सिम्स
siyasi	सियासी
siyah	सियाह
siyaha	सियाहा
sirpur	सिरपुर
sivan	सिवन
siwan	सिवन
sisva	सिस्वा
siswa	सिस्वा
cil	सिल
csi	ससस
sikar	सिकर
seaten	सीटें
sitaram	सीताराम
sitaharan	सीताहरण
cpm	सपम
cps	स्पीस
cbse	स्कब
seem	सीम
sim	सिम
sealed	सीलेड
shield	शिल्ड
ccd	ससीडी
sugamata	सुगमता
sugmta	सुगमता
sujan	सूजन
sujen	सुजे
suken	सुकेन
sujain	सुजान
sujhaati	सुझाती
sujhati	सुझाती
sutali	सुतली
sutli	सुतली
suta	सूता
sdueep	स्द्पीप
sudip	सुदीप
sudhaargrah	सुधार्ग्ह
sudhargrih	सुधारगृह
sudhargruh	सुधारगृह
sunaaron	सुनारों
sunaron	सुनारों
sunaseer	सुनाीीर
sunasir	सुनासरर
suneeti	सुनीति
suniti	सुनीति
sunega	सुनेगा
suneyga	सुनेगा
superhit	सुपरहित
supachy	सुपाच्य
supachya	सुपच््य
supachye	सुपाच्य
subhaay	सुभाय
subhay	सुभाय
surveen	सर्वीन
survin	सर्विन
surana	सुराा
sulkhan	सुल्खन
suljaayi	सुलजायी
suljayi	सुलजाय
suljhai	सुलझाई
sulzai	सुलझाई
sultana	सुल्ताना
sulaati	सुलाती
sulati	सुलतत
susanskrit	सुसंस्कृत
susanskrut	सुसंस्कृत
suhagin	सुहागीन
soond	सूंद
sund	संद
suiyan	सुइयां
sukhati	सुखती
sukhti	सुखती
sukhakar	सुखाकर
soochak	सूचक
suchak	सूचक
sooja	सूजा
suja	सुजा
suba	सबबा
sube	सुबे
sooraj	सूरज
suraj	सुरज
surinaam	सुरीनाम
surinama	सुरिनामा
suriname	सुरिणाम
suryadev	सूर्यदेव
sendha	सेंधा
senvai	सेंवाई
sevai	सेवाई
sensing	सेंसेंग
sexual	सेक्सुाल
saturday	सतुर्दय
seti	सेती
seto	सेटो
seth	सेठ
safety	साफे््ी
semen	सीमेन
semin	सेमिन
self	सेल्फ
selfie	सेल्फी
save	सावे
sev	सेव
sevakon	सेवकों
sevkon	सेवकों
samuels	सेम्यल्स
celery	सेलररी
salary	सैलाय
sakar	साकर
socar	सोकरर
soccer	सॉस्सर
songs	सोंग्स
solicitor	सॉलीसिटर
sochane	सोचने
sochne	सोचने
sonu	सोनु
soma	सोमा
spma	स्पमा
somi	सोमि
soy	सोय
soya	सोया
solitaire	सोलेटायर
soharai	सोहराई
sohrai	सोहराई
sohaval	सोहवाल
sohawal	सोहवाल
saunpane	सौनपने
sonpne	सौंपन
scala	स्केला
skala	स्कला
ski	स्की
scootaron	स्कूतरों
scooteron	स्कूटरों
skootaron	स्कूतरों
scandinavia	स्कैंडिनाविया
scaining	स्केनिंग
scanning	स्केनिंग
squash	स्क्वेश
squash	स्क्वेश
skhalan	स्खलन
stain	स्टेन
stan	स्तान
stop	स्टॉप
stops	स्टॉप्स
stone	स्टोन
straws	स्ट्रास
stress	स्ट्रेस
stra	स्त्रा
stray	स्त्राय
stre	स्ट्रे
strocks	स्ट्रॉक्स
strokes	स्ट्रोक्स
stan	स्तान
stanadhari	स्तनधारी
standhaari	स्तनधारी
standhari	स्तनधारी
sthiti	स्थिति
stithi	स्तिथि
stuti	स्तुत
sthitiyaan	स्थितियां
sthitiyan	स्थितियां
sthitiyon	स्थितियों
sthool	स्थूल
sthul	स्थुल
sthoolta	स्थूलता
sthulata	स्थुलता
sneakers	स्नेकर्स
snickers	स्निकर्स
snikarse	स्निका््
spear	स्पीयर
spell	स्पेल
spelar	स्पेलर
speller	स्पिलर
sprint	स्प्रिंट
sprit	स्प्रिट
spray	स्प्राय
spry	स्प्री
sfoorti	सफूर्ति
sfurti	सफूर्ती
sphoorti	स्फूर्ति
slide	स्लाइड
slider	स्लीडर
slaaidon	स्लाईडों
slidon	स्लीडों
sliders	स्लाइडर्स
slides	स्लीडेस
slice	स्लाइस
slash	स्लशश
swaroopon	स्वरूपों
swarupon	स्वरूपों
swa	स्वा
swaachaalit	स्वचचलित
swachalit	स्वचालित
swaarthparak	स्वार्थपरक
swarthparak	स्वार्थपरक
swiftlate	स्विफलेटट
swiftlet	स्विफेलेट
sweekarte	स्वीकारते
swikarte	स्वीकारते
sweet	स्वीत
sweep	स्वीप
sweccha	स्वेच्छ
swecha	स्वेच्छ
swechha	स्वेच्छ
sweta	स्वेता
swap	स्पाप
swipe	स्वपपी
handiya	हंडिया
handiyaa	हंडिया
hundiya	हुंडिया
hakikat	हकककित
haqeeqat	हकीकत
hathiya	हाथिया
hamala	हमला
hamla	हमला
hamalavar	हमलावर
hamlavar	हमलावर
humlavar	हमलावर
hamaal	हमाल
hamal	हमल
hercules	हर्कुल्स
hardas	हरदास
harpaal	हरपाल
harpal	हरपाल
harvansh	हरवंश
haraval	हरावाल
harawal	हरावाल
hurricane	हरुरिकने
harijan	हरिजन
hariyali	हरियाली
harshit	हर्षित
haldi	हल््ी
halla	हल्ला
hawamahal	हवमाहल
hawalaat	हवालात
hawalat	हवालत
hasino	हससननो
hasinon	हससनोो
haan	हान
han	हनन
haanfte	हानफ्ट
hafate	हफतते
hanfte	हनफफे
higman	हिग्मन
hymen	हाममेन
hadauti	हड़ौती
haani	हानी
hani	हानि
haarjeet	हार्जत
harjeet	हरजीत
haaranaa	हरनना
harana	हराना
harna	हरना
haalchaal	हलचाल
haalchal	हलचल
halchaal	हलचाल
halchal	हलचल
halt	हलट
hault	हॉल्ट
hahakar	हचकर
hingis	हिंगीस
hindan	हिंदन
hindon	हिंदों
hijada	हिजड़ा
hijda	हिजड़ा
hijbul	हिजबुल
hippo	हिप्पो
hippopotamus	हिप्पोपोटामस
himali	हिमाली
hilane	हिलाने
hilne	हिलने
hisham	हिशम
heeraganj	हीरागंज
hiraganj	हीरागंज
heroes	हेरोज़
heros	हेरोस
hui	हुई
huin	हूइन
hooper	हूपर
huppar	हपप्र
hupper	हप्पर
hegde	हगगड़े
hemvati	हेमवाती
hemwati	हेमवतत
help	हे्प
helper	हेल्पर
haito	हैतो
hairam	हैराम
harem	हेरम
herald	हेराल्ड
haive	हैवे
have	हावे
hong	होंग
half	हलफ
hoaf	होफ
hounga	हौंगा
holding	होल्डिंग
hoshangabaad	होशंगाबाद
hoshangabad	होशंगाबाद
hostes	होस्टेस
hostess	होस्टेस
