ank	अंक	अंक
anka	अंका	अंक
ankit	अंकित	अंकित
anakon	अनकों	अंकों
ankhon	अंखों	अंकों
ankon	आंकों	अंकों
angkor	अंगकोर	अंकोर
ankor	अंकोर	अंकोर
angaarak	अंगारक	अंगारक
angarak	अंगारक	अंगारक
angraji	अंग्रजी	अंग्रज़ी
angreji	अंग्ेजजी	अंग्रज़ी
angrzi	अंग्रजी	अंग्रज़ी
antah	अंटा	अंतः
antaha	अंताा	अंतः
antarmukh	अंतरमुख	अंतर्मुख
antmurkh	अंतमूर्ख	अंतर्मुख
antrmukh	अंतर्मुख	अंतर्मुख
andrabee	अंदराबी	अंद्राबी
andrabi	अंदराबी	अंद्राबी
andha	अंधा	अंधा
andhapan	अंधपान	अंधापन
andheri	अंधेरी	अंधेरी
ambaani	अंबानी	अंबानी
ambani	अंबानी	अंबानी
akram	अक्रम	अकरम
acapulco	अकापुलको	अकापुल्को
akapulko	अकापुलकों	अकापुल्को
akhand	अखंड	अखंड
akhil	अखिल	अखिल
agavai	अगवाई	अगवाई
agvaai	अग्वाई	अगवाई
augustine	अगस्टीन	अगस्टाइन
augustustine	अगस्टस्टीन	अगस्टाइन
agsta	अगससता	अगस्ता
agusta	अगुस्त	अगस्ता
augusta	अगुस्त	अगस्ता
agr	अग्र	अग्र
agra	अग्र	अग्र
achambha	अचंभा	अचंभा
achanbha	अचंभा	अचंभा
achievement	अशीवमेंट	अचीवमेंट
achivement	अचिवेमेंट	अचीवमेंट
acchi	अच्छी	अच्छी
achchi	अच्छी	अच्छी
achhi	अछी	अच्छी
achyut	अचूत	अच्युत
achhanera	अच्नेरा	अछनेरा
achnera	अचनेरा	अछनेरा
ajmeedh	अजमीध	अजमीढ़
ajhar	आजार	अजहर
azhar	आजार	अजहर
ajit	अजीत	अजित
agnat	अग्नात	अज्ञात
agyaat	अज्ञात	अज्ञात
agyat	अज्ञात	अज्ञात
atakta	अटकता	अटकता
atkata	अत्कता	अटकता
atake	अटकक	अटके
atke	अटके	अटके
atwaal	अतवाल	अटवाल
atwal	अतववल	अटवाल
attahasa	अत्तहसा	अट्टहास
atthaas	अत्थास	अट्टहास
atthas	अत्थास	अट्टहास
addon	अद्नों	अड्डों
athak	अठक	अथक
atharv	अठर्व	अथर्व
atharva	अठरव्व	अथर्व
adad	अदाद	अदद
adaani	अदानी	अदाणी
adani	अदानी	अदाणी
advait	अद्वैत	अद्वैत
adwait	अद्वैत	अद्वैत
advaitvaad	अद्वैतवाद	अद्वैतवाद
advaitwad	अद्वैतवाद	अद्वैतवाद
adhivas	अधिवास	अधिवास
adhiwas	अधिवास	अधिवास
advivas	अद्विवास	अधिवास
adhiik	अधिक	अधीक
adhik	अधिक	अधीक
adhyayanarat	अध्ययनारत	अध्ययनरत
adhyayanrat	अध्ययन्रत	अध्ययनरत
adhyaynrat	अध्ययन्रत	अध्ययनरत
anant	अनंत	अनंत
ananti	अनंती	अनंती
angadh	अंगढ़	अनगढ़
angarh	अंगढ़	अनगढ़
anchahe	अंचहे	अनचाहे
anthak	अंठक	अनथक
unthak	उंठक	अनथक
anhoni	अन्होनी	अनहोनी
anaavashyak	अनावश्यक	अनावश्यक
anavashyak	अनववश्यक	अनावश्यक
anavshyak	अनववश्यक	अनावश्यक
anawashyak	अनववश्यक	अनावश्यक
anik	अनिक	अनिक
anishwarvadi	अनिश्वरवादी	अनीश्वरवादी
anishwarwadi	अनिश्वरवादी	अनीश्वरवादी
anukoltha	अनुकोल्था	अनुकूलता
anukulata	अनुकुलता	अनुकूलता
anukulta	अनुकुलता	अनुकूलता
anuchit	अनुचित	अनुचित
anuprayogi	अनुप्रयोगी	अनुप्रयोगों
anuprayogon	अनुप्रयोगों	अनुप्रयोगों
anupryogon	अनुप्रोगों	अनुप्रयोगों
anureet	अनुरीत	अनुरीत
anurit	अनुरित	अनुरीत
anuthi	अनुठी	अनूठी
anudit	अनुदित	अनूदित
anyaay	अन्याय	अन्याय
anyay	अन्याय	अन्याय
anyaya	अन्याय	अन्याय
apnani	अपनानी	अपनानी
aparivartanshali	अपरिवर्तनशाली	अपरिवर्तनशील
aparivartansheel	अपरिवर्तनशील	अपरिवर्तनशील
aparivartanshil	अपरिवर्तनशील	अपरिवर्तनशील
apariharya	अपरिहर्य	अपरिहार्य
aprihary	अपररहारय	अपरिहार्य
apriyary	अप्रियारय	अपरिहार्य
apavartit	अपवर्तित	अपवर्तित
apvartit	अपवर्तित	अपवर्तित
apvtrit	अपवतृतत	अपवर्तित
apaardarshi	अपारदर्शी	अपारदर्शी
apardarshi	अपरदर्शी	अपारदर्शी
afroj	अफरोज	अफरोज
afroz	अफरोज़	अफरोज
africa	अफ्रिका	अफ्रीका
abbaasi	अब्बासी	अब्बासी
abbasi	अब्बासी	अब्बासी
abhimat	अभिमत	अभिमत
abhishap	अभिषप	अभिशाप
abhi	अभी	अभी
amjhera	अमझेरा	अमझेरा
amzera	अमजेरा	अमझेरा
amargad	अमरगढ़	अमरगढ़
amargarh	अमरगढ़	अमरगढ़
amarpaal	अमरपाल	अमरपाल
amarpal	अमरपाल	अमरपाल
amarohi	अमरोही	अमरोही
amrohi	अमरोही	अमरोही
amaanat	अमानत	अमानत
amanat	अमानत	अमानत
amanth	अमांठ	अमानत
amaanati	अमानती	अमानती
amanathi	अमानथी	अमानती
amanati	अमानती	अमानती
amavasya	अमावस्य	अमावस्या
amavsya	अमावस्य	अमावस्या
amit	अमिट	अमित
amitao	अमिताओं	अमिताव
amitav	अमितााव	अमिताव
amuk	अमुक	अमुक
amogh	अमोघ	अमोघ
ambani	अंबानी	अम्बानी
ayodhyaanaath	अयोध्यानाथ	अयोध्यानाथ
ayodhyanaath	अयोद्यनाथ	अयोध्यानाथ
ayodhyanath	अयोद्यनाथ	अयोध्यानाथ
ayodhyeanath	अयोध्यनाथ	अयोध्यानाथ
aradas	अरादास	अरदास
ardaas	अर्दास	अरदास
ardas	अर्ास	अरदास
arabab	अरबब	अरबाब
arbab	अरबाब	अरबाब
around	आराउंड	अराउंड
arjent	आर्जेंट	अर्जेंट
urgent	उर्जेंट	अर्जेंट
arth	आर्थ	अर्थ
artha	अर्थ	अर्थ
earth	ईर्थ	अर्थ
earthquake	इर्थकुकक	अर्थक्वेक
arthon	आर्थो	अर्थों
arpit	आर्पित	अर्पित
aryama	आर्यमा	अर्यमा
aryma	आर्यमा	अर्यमा
arymaa	आर्यमा	अर्यमा
alankaar	अलंकार	अलंकार
alankar	अलंकार	अलंकार
alnkaar	अलंकार	अलंकार
alankaaron	अलंकारों	अलंकारों
alankaron	अलंकारों	अलंकारों
alnkaaron	अलंकारों	अलंकारों
alnkaron	अलंकारों	अलंकारों
alagavavadi	अलगववाड़ी	अलगाववादी
algavvadi	अल्गववादी	अलगाववादी
algavwaadi	अल्गववादी	अलगाववादी
alive	अलिव	अलाइव
alance	अलांस	अलायंस
alayans	अलयंस	अलायंस
aliance	एलायंस	अलायंस
alind	अलिंड	अलिंद
alai	अलाई	अली
ali	एली	अली
alii	आली	अली
alonso	आलॉनसो	अलोंसो
aloso	आलोसो	अलोंसो
alphabet	अल्फेबेट	अल्फ़ाबेट
alba	अल्बा	अल्बा
avantipur	अवंतीपुर	अवंतिपुर
awantipora	अवांतिपोर	अवंतिपुर
avaru	अवरू	अवरु
avru	अवरू	अवरु
awaru	अवरू	अवरु
avarodhak	अवरोधक	अवरोधक
avrodhak	अवरोधक	अवरोधक
avrodhk	अवरोधक	अवरोधक
avarnata	अवर्णता	अवर्णता
avarnataa	अवर्णता	अवर्णता
avranta	अवरंता	अवर्णता
avashist	अवशिष्ट	अवशिष्ट
avshisht	अवशिष्ट	अवशिष्ट
awashist	अवशिष्ट	अवशिष्ट
avasthaayen	अवस्थाएं	अवस्थाएं
avsthaen	अवस्थाएं	अवस्थाएं
avsthayen	अवस्थाएं	अवस्थाएं
awasthaen	अवस्थाएं	अवस्थाएं
avi	अवी	अवि
avika	अविका	अविका
aviral	अविरल	अविरल
avirl	अवर्ल	अविरल
avishvaasniy	अविश्वससनीय	अविश्वसनीय
avishvasniy	अविश्वसनीय	अविश्वसनीय
avishvasniya	अविश्वसनीय	अविश्वसनीय
avisvasniya	अविश्वस्ीीय	अविश्वसनीय
aviva	अविवा	अवीवा
avaigyanic	अवैज्ञानिक	अवैज्ञानिक
avaigyanik	अवैज्ञानिक	अवैज्ञानिक
avegyanik	अवेज्ञानिक	अवैज्ञानिक
ashaktataa	आशक्तता	अशक्तता
ashktta	आशक्तता	अशक्तता
asharaphi	अशारफी	अशरफी
ashrafi	अशरफी	अशरफी
ashariri	अशरररी	अशरीरी
ashriri	अश्री	अशरीरी
ashrvatath	अशररवताथ	अश्वत्थ
ashvtth	अश्वत्त	अश्वत्थ
asamaany	असमान््य	असमान्य
asamany	असामान्य	असमान्य
asmanye	असमानन्य	असमान्य
asaamnjsy	असामंजसीय	असामंजस्य
asamanjasy	असमंजस्य	असामंजस्य
asamanjasya	असमंजस्य	असामंजस्य
asurakshit	असुरक्षित	असुरक्षित
asurkshit	असुरक्षित	असुरक्षित
aset	असेत	असेट
asset	असेट	असेट
asvabhavik	अस्वाभाविक	अस्वभाविक
aswabhavik	अस्वाभाविक	अस्वभाविक
aswbhavik	अस्वभाविक	अस्वभाविक
ahirauli	अहिरौली	अहिरौली
item	इइटमम	आइटम
items	इइटम्स	आइटम्स
idle	इइडल	आइडल
idol	इडडोल	आइडल
icc	आईसीसी	आइसीसी
iso	इसससओ	आइसो
ipc	आईपीसी	आईपीसी
ipad	इपाद	आईपैड
iris	आइरिस	आईरिस
ounce	ओंस	आउंस
aakaash	आकाश	आकाश
aakash	आकाश	आकाश
aake	आके	आके
aakhet	आखेत	आखेट
akhet	अखेत	आखेट
aagat	आगत	आगत
aagaman	आगमनन	आगमन
aagman	आगमाान	आगमन
aagaa	आगा	आग़ा
aagah	आगहह	आग़ा
agha	अघा	आग़ा
aagaashe	आगाशे	आगाशे
aagashe	आगशे	आगाशे
agashe	अगशे	आगाशे
aajmaanaa	आजमाना	आजमाना
aajmana	आजमाना	आजमाना
aazmaanaa	आजमाना	आजमाना
aata	आता	आटा
ata	अटा	आटा
atta	अत्ता	आटा
aatmayen	आत्माएं	आत्माएं
atmaen	आत्माएं	आत्माएं
aadaan	आदान	आदान
aadan	आदनन	आदान
aadhaarit	आधारित	आधारित
aadharit	आधारत	आधारित
adharit	अधृत	आधारित
aadheen	आधीन	आधीन
aadhin	आधीन	आधीन
aadhunik	आधुनिक	आधुनिक
aanad	आनद	आनद
aanand	आनंद	आनद
anand	आनंद	आनद
aapka	आपका	आपका
aapkaa	आपका	आपका
aapadaaaen	आपदाएं	आपदाएं
aapdaein	आपदाएं	आपदाएं
aapdayein	आपदाएं	आपदाएं
aabantit	आबंतीत	आबंटित
abantit	अबंतीत	आबंटित
aabru	आबरू	आबरू
abaru	अबररू	आबरू
aamdan	आमदान	आमदन
amadan	अमददन	आमदन
aamdani	आमदानी	आमदनी
amadani	अमादनी	आमदनी
aamdi	आमदी	आमदी
amdi	अमदी	आमदी
aamod	आमोद़	आमोद
amod	अमोड़	आमोद
aayenge	आएेंगे	आयेंगे
aayojak	आयोजक	आयोजक
ro	रो	आरओ
rp	आरपी	आरपी
aaraam	आराम	आराम
aaram	आरमम	आराम
aram	आराम	आराम
aarushi	आरुषि	आरुषि
arushi	अरषि	आरुषि
artery	आर्टरी	आर्टरी
order	ऑर्डर	आर्डर
aary	आरीय	आर्य
aarya	आर्य	आर्य
arya	आर्य	आर्य
aaryika	आर्यिका	आर्यिका
aryika	आर्यिका	आर्यिका
aarya	आर्य	आर्यो
arya	आर्य	आर्यो
aryo	एर्यो	आर्यो
aaryan	आर्यान	आर्यों
arya	आर्य	आर्यों
aryon	अर्यों	आर्यों
aalsi	आलसी	आलसी
alasi	अलासी	आलसी
aalochak	आलोचक	आलोचक
alochak	आलोचक	आलोचक
aalochakon	आलोचकों	आलोचकों
alochakon	आलोचकों	आलोचकों
aalha	आल्हा	आल्हा
aalhaa	आल्हा	आल्हा
alha	अल्हा	आल्हा
allah	अल्लाह	आल्हा
aawaazen	आवाजें	आवाज़ें
aawajen	आवाजें	आवाज़ें
awaazen	आवाजें	आवाज़ें
awazen	अवाजेन	आवाज़ें
aawajon	आवाजों	आवाज़ों
aawazon	आवाजों	आवाज़ों
awaazon	आवाजों	आवाज़ों
awazon	आवाजों	आवाज़ों
aavishakaar	आविषाकार	आविष्कार
aavishkaar	आविष्कार	आविष्कार
avishkar	अविष्कार	आविष्कार
aavriti	आवृति	आवृत्ति
aavritti	आवृत्ति	आवृत्ति
avuti	अवुति	आवृत्ति
aavritiyon	आवृतियों	आवृत्तियों
aavrittiyon	आवृत्तियों	आवृत्तियों
avrutiyon	अवृतियों	आवृत्तियों
aashanka	आशंका	आशंका
ashanka	आशंका	आशंका
aashriton	आश्रीतों	आश्रितों
ashriton	अश्रीतों	आश्रितों
aasaan	आसान	आसान
aasan	आसन	आसान
asan	आसन	आसान
aastik	आस्तिक	आस्तिक
astik	आस्तिक	आस्तिक
aasteen	आस्तीन	आस्तीन
aastin	आस्तिन	आस्तीन
astin	एस्तिन	आस्तीन
aahnaan	आहनान	आह्नान
aahnan	आहनान	आह्नान
ahyan	आह्यान	आह्नान
england	इंग्लैंड	इंग्लैंड
engineer	इंजीनियर	इंजिनियर
introduction	इंट्रोडक्शन	इंट्रोडक्शन
insurance	इंसुरंस	इंश्योरेंस
ear	इर	इअर
eyer	इयर	इअर
eon	इओन	इआन
iaan	इयान	इआन
ekattha	इक्ट्ठा	इकट्ठा
ikattha	इक्ट्ठा	इकट्ठा
ekatthi	इक्टीठी	इकठ्ठी
ekthi	इक्ठी	इकठ्ठी
ikatthi	इक्टी	इकठ्ठी
ekaee	इकाई	इकाई
ikai	ईकाई	इकाई
ekaeyon	इकाइयों	इकाईयों
ikaiyon	इकाइयों	इकाईयों
ikarion	इकारियों	इकाईयों
economic	इकोनमिक	इकोनोमिक
ecuador	इक्यूडोर	इक्वाडोर
equador	इक्वूडोर	इक्वाडोर
equities	इक्विटीज	इक्विटीज
ikvitija	इक्वितिजा	इक्विटीज
ijaajat	इज़ाजत	इजाजत
ijajat	इज़जजत	इजाजत
inhalation	इन्हालेशन	इनहेलेशन
inhaletion	इन्हालेशन	इनहेलेशन
ibija	इबिजा	इबीजा
ibiza	इबिज़ा	इबीजा
imaging	इमैजिंग	इमेजिंग
immune	इम्यून	इम्युन
elaichi	इलैची	इलाइची
ilaichi	इलाची	इलाइची
ilayachi	इलययची	इलाइची
ilayichi	इलायिची	इलाइची
elaaj	इलाज	इलाज
ilaaj	इलाज	इलाज
ilaj	इलााज	इलाज
ishaak	इशाक	इशाक
ishaaq	इशाक	इशाक
ishak	इश्क	इशाक
ishaara	इशारा	इशारा
ishaaraa	इशारा	इशारा
ishara	इशारा	इशारा
ishita	इशिता	इशिता
isht	इष्ट	इष्ट
isteefe	इस्तीफ	इस्तीफे
istife	इस्टीफफ	इस्तीफे
ea	इ	ईए
ia	आईएईए	ईए
eater	इटर	ईटर
iter	आइटर	ईटर
email	इमेल	ईमेल
emailon	इमेलों	ईमेलों
emelon	इमेलों	ईमेलों
evening	इवनिंग	ईवनिंग
east	ईस्ट	ईष्ट
ishat	इष्ट	ईष्ट
isht	इष्ट	ईष्ट
isaaiyon	ईसाइयों	ईसाइयों
isaiyon	ईसाइयों	ईसाइयों
isayiyon	ईसाईयों	ईसाइयों
ikhrul	इखरूल	उखरुल
ukhrool	उखरूल	उखरुल
ukhrul	उखरूल	उखरुल
uchhalane	उछलनने	उछालने
uchhalne	उछलने	उछालने
ujback	उजजबैक	उज़्बेक
uzbek	उज़्बेक	उज़्बेक
uthane	उठान	उठने
uthne	उठने	उठने
uthaakar	उठाकर	उठाकर
uthakar	उठार	उठाकर
uthaapatak	उठापटक	उठापटक
uthapatak	उठापटक	उठापटक
uthen	उठाएं	उठें
udaan	उड़ान	उड़ान
udan	उड़न	उड़ान
udaanaa	उड़ना	उड़ाना
udana	उड़ना	उड़ाना
udaane	उड़ाने	उड़ाने
udane	उड़ने	उड़ाने
udaanen	उड़नें	उड़ानें
udanen	उड़नें	उड़ानें
udaanon	उदानों	उड़ानों
udanon	उद़नों	उड़ानों
utane	उताने	उतने
utaney	उतने	उतने
utne	उतने	उतने
uttara	उत्तार	उत्तरा
uttra	उत्तर	उत्तरा
utpan	उत्पान	उत्पन
udant	उद्तत	उदंत
udghosh	उद्घोष	उदघोष
udar	उदार	उदर
uda	उड़ा	उदा
udaa	उड़ा	उदा
udakishuganj	उदककीशुगज	उदाकिशुनगंज
udakishunganj	उदककीशुंगज	उदाकिशुनगंज
unatees	युनाीीस	उनतीस
untees	उंतीस	उनतीस
uniyal	यूनियाल	उनियाल
upadraviyon	उपद्रववयों	उपद्रवियों
updravion	उपड्ररववों	उपद्रवियों
updraviyon	उपद्ररवियों	उपद्रवियों
upadravi	उपद्रवी	उपद्रवी
updravi	उपद्रववी	उपद्रवी
upadrawon	उपद्रवों	उपद्रवों
updravon	उपद्ररवों	उपद्रवों
upneta	उपनेता	उपनेता
upabhokta	उपभोकता	उपभोक्ता
upbhokta	उपभोकता	उपभोक्ता
uplaksh	उपलाक्ष	उपलक्ष्य
uplakshay	उपलाक्षय	उपलक्ष्य
uplakshya	उपलाक्ष्य	उपलक्ष्य
uplabdh	उपलब्ध	उपलब्ध
uplabdhiyon	उपलाब्धियों	उपलब्धियों
uplabdhi	उपलाबधध	उपलब्धी
upakhyaanon	उपख्यानों	उपाख्यानों
upakhyanon	उपख्यानों	उपाख्यानों
ubuntu	उबूंटू	उबंटू
ubaal	उबाल	उबाल
ubal	उबल	उबाल
ubhaara	उभररा	उभारा
ubhara	उभरर	उभारा
umanath	उमानथ	उमानाथ
umesh	उमेश	उमेश
urf	उर्फ	उर्फ
urfa	उर्फा	उर्फ
urff	उर्फफ	उर्फ
urvarakon	उर्वरकों	उर्वरकों
urvarkon	उर्वरकों	उर्वरकों
urwarakon	उर्वरकों	उर्वरकों
urvarata	उर्वरता	उर्वरता
urvarta	उर्वरता	उर्वरता
urwarta	उर्वरता	उर्वरता
ulate	उलाते	उलटे
ulte	उल्टे	उलटे
ulahana	उलहना	उलाहना
ulahna	उलहना	उलाहना
ulema	उलेलेमा	उलेमा
ulemaon	उलेलेमाओं	उलेमाओं
usak	उसक	उसक
usaki	उसकी	उसकी
uski	उसकी	उसकी
usmein	उस्में	उसमें
usmen	उस्में	उसमें
usi	उससी	उसी
ustara	उस्तराा	उस्तरा
udharv	उधारवव	ऊर्ध्व
udhrva	उधररव	ऊर्ध्व
urdhav	उर्धवव	ऊर्ध्व
ushma	उष्मा	ऊष्मा
rishicool	रििकूल	ऋषिकुल
rishikul	ऋषिकुल	ऋषिकुल
rushikul	ऋषिकुल	ऋषिकुल
enzyme	इंजीमम	एंजाइम
anton	अंटों	एंटोन
entone	इंटोन	एंटोन
antoni	अंटोनी	एंटोनी
antony	एंटोनी	एंटोनी
endometrial	इंडोमेट्रियल	एंडोमेट्रियल
andreas	एंड्रीज	एंड्रियास
als	अल्स	एएलएस
asi	आसी	एएसआई
eksaath	एकसाथ	एकसाथ
eksath	एकस्थ	एकसाथ
ekaki	इकाकी	एकाकी
xm	एक्सम	एक्सएम
egmor	एग्मोर	एगमोर
egmore	इग्ोोर	एगमोर
aj	आज	एजे
agende	एजेंडे	एजेंडे
adp	अडपपी	एडीपी
adain	अदैद	एडेन
aden	अडेन	एडेन
edan	एडान	एडेन
addi	अद्दी	एड्डी
eddi	एडीडी	एड्डी
eddie	एडीीी	एड्डी
eddy	एडीी	एड्डी
apj	अपज	एपीजे
ftii	फ्टी	एफटीआईआई
abbott	अब्बॉट	एबट
abut	अबूट	एबट
ebt	इब्ट	एबट
abvp	अब्वपप	एबीवीपी
abbot	अब्बोट	एबोट
abbott	अब्बॉट	एबोट
mta	माटा	एमटीए
mtake	मटटक	एमटेक
mtec	मैटेक	एमटेक
mtech	मटटक	एमटेक
emerald	इमेललड	एमरल्ड
emrald	इमरलल्ड	एमरल्ड
emil	एमिल	एमिल
emile	एमिले	एमिल
emily	इमिली	एमिल
amy	अम्य	एमी
emi	एमी	एमी
airway	एयरवाय	एयरवे
eyarave	एयरवव	एयरवे
eyarve	एयरवव	एयरवे
error	एरोर	एरर
arica	अरिका	एरिका
erica	एरिका	एरिका
erika	एरिका	एरिका
aerobic	एयरोबिक	एरोबिक
aerobics	एयरोिक्स	एरोबिक
lte	ललटे	एलटीई
lti	लटटी	एलटीई
allergic	अलर्जिक	एलर्जिक
eliminator	एलीमिनेटर	एलिमिनेटर
aliens	एलींस	एलियंस
alliance	एलायंस	एलियंस
asian	एशिया	एशियन
sfc	ससफससी	एसएफसी
sk	स्के	एसके
spf	सपपीए	एसपीएफ
association	असोसिएशन	एसोसिएशन
astar	अस्तर	एस्टर
aster	अस्टर	एस्टर
ester	एस्टर	एस्टर
aesthetics	एइस्थेटिक्स	एस्थेटिक
asthetic	अस्थेटिक	एस्थेटिक
asfalt	असफल्ट	एस्फाल्ट
asphalt	अस्फलत	एस्फाल्ट
asphault	अस्फॉलटट	एस्फाल्ट
ahsaas	अहसास	एहसास
ehsaas	एहसास	एहसास
ehsas	एहसास	एहसास
aisa	ऐसा	एेसा
eesa	ईससा	एेसा
ainth	ऐंठ	ऐंठ
end	ऐंड	ऐंठ
enth	ऐंठ	ऐंठ
ainthey	ऐंठे	ऐंठे
enthe	ऐंठे	ऐंठे
aithan	ऐंठन	ऐठन
ethan	ऐठनन	ऐठन
ethhan	ऐठठन	ऐठन
ail	ऐएल	ऐल
el	इल	ऐल
alaps	अलाप्स	ऐल्प्स
alps	अल्प्स	ऐल्प्स
aise	ऐसे	ऐसे
oxide	ऑक्साइड	ऑक्साइड
oxy	ऑक्सी	ऑक्सी
offers	ऑफर्स	ऑफर्स
offshor	ऑफफरोर	ऑफशोर
offshore	ऑफफोोर	ऑफशोर
official	ऑफिशियल	ऑफिशियल
okalahoma	ओकलाहोमा	ओकलाहोमा
oklahoma	ओकलाहोमा	ओकलाहोमा
oklahoma	ओकलाहोमा	ओक्लाहोमा
ot	ओटी	ओत
opel	ओपेल	ओपेल
obrayan	ओब्रायन	ओब्रायन
obrien	ओब्राएन	ओब्रायन
oran	ओरान	ओरण
orian	ओरिया	ओरियन
orion	ओरियन	ओरियन
olavrishti	उलावृष्टि	ओलावृष्टि
ovum	ओवम	ओवम
owem	ओवम	ओवम
oceanic	ऑसीनिक	ओशनिक
osaka	ओसका	ओसाका
auchity	औचित्य	औचित्य
auchitya	औचित्या	औचित्य
audhyogikaran	औद्योगिकरण	औद्योगिकरण
audyogikarana	औद्योगिकरण	औद्योगिकरण
audyogikikaran	आद्योगिकीकरण	औद्योगिकरण
aurangabad	औरंगाबड़	औरंगाबाद
aurora	औरोड़ा	औरोरा
aulakh	औलख	औलख
kankad	कंकड़	कंकड़
kankar	कनकरर	कंकड़
kankad	कंकड़	कंकर
kankar	कनकरर	कंकर
kangan	कंगान	कंगन
conjunction	कंजजुक्शन	कंजंक्शन
contemporary	कंटेपरोरी	कंटेम्पररी
kanthahar	कंठहर	कंठहार
kanthhar	कंठर	कंठहार
composer	कंपोजर	कंपोजर
kambalon	कांबलों	कंबलों
kanblon	कांबलों	कंबलों
consultant	कंसल्टेंट	कंसलटेंट
kakkad	कक्कड़	कक्कड़
kakkar	कक्कार	कक्कड़
kacche	कच्चे	कच्चे
kachche	कच्चे	कच्चे
karta	कर्ताा	कटरा
katra	कततर	कटरा
cutlery	कटललीीी	कटलरी
katlari	कत्लारी	कटलरी
katlary	कटटाराय	कटलरी
katasaraj	कतासराज	कटासराज
kathfodave	कठथफोड़व	कठफोड़वे
kathfodve	काठफोड्व	कठफोड़वे
kathor	कथोर	कठोर
kathore	कथौरे	कठोर
kanika	कानिका	कणिका
kathai	कथाई	कत्थई
katthai	कट्थाई	कत्थई
katthaii	कट्थाई	कत्थई
convention	कन्वेशन	कनवेंशन
canals	कैनल्स	कनाल
kanaal	कनाल	कनाल
kanal	कनाल	कनाल
kanindham	कनिंधम	कनिंघम
kaningham	कनिंघम	कनिंघम
kanishthika	काििष्ठिका	कनिष्ठिका
kanishthikaa	कनििष्ठिका	कनिष्ठिका
kanishtika	काििष्टिका	कनिष्ठिका
kanyaayen	कन्याएं	कन्याएं
kanyaein	कन्याएं	कन्याएं
kanyayen	कन्याएं	कन्याएं
convention	कन्वेशन	कन्वेंशन
convocation	कन्वोकेशन	कन्वोकेशन
cup	कपप	कप
kap	कपप	कप
kapda	कपड़ा	कपड़ा
kpada	कपाड़ा	कपड़ा
kapdo	कपड़ो	कपड़ो
kapdon	कपड़ों	कपड़ो
kaping	कैपिंग	कपिंग
kping	केपिंग	कपिंग
kapolkalpana	कपपोलकल्पना	कपोलकल्पना
kabaddi	कबाद्दी	कबड्डी
kabr	कबरर	कब्र
kabra	काबरा	कब्र
kabren	कबरेेन	कब्रें
kabron	कबरों	कब्रों
kamjor	कमजजोर	कमज़ोर
kamzor	कमजजोर	कमज़ोर
kamatar	कमाटार	कमतर
kamtar	कामटर	कमतर
kalamjeet	कलममजीत	कमलजीत
kamaljeet	कमलजीत	कमलजीत
kamaauu	कमाऊ	कमाऊ
kamau	कमाऊ	कमाऊ
kamaate	कमाते	कमाते
kamate	कमाते	कमाते
kamere	कमेरे	कमेरे
kmere	कमेरे	कमेरे
karanj	करणज	करंज
kranj	क्रंज	करंज
karanjiya	करणजीय	करंजिया
kardhe	कर्धे	करघे
karghe	कारघे	करघे
karachana	करानाना	करछना
karchhana	कर्चना	करछना
karna	कररनन	करना
karpatri	कापत्रर	करपात्री
karam	करराम	करम
karoor	करूर	करूर
karur	करूर	करूर
karnataka	कार्नकाा	कर्नाटका
karvi	कारवीी	कर्वी
kurvi	कुर्वी	कर्वी
kalmein	कलमेें	कलमें
kalmen	कलममें	कलमें
kalraj	कलरााज	कलराज
kalika	कालिकाा	कलिका
kalpanaon	कल्पनाओं	कल्पनाओं
kalpnaon	कल्पनाओं	कल्पनाओं
kavvaliyon	कवववालियों	कव्वालियों
qawwaliyon	क़व्वालियों	कव्वालियों
kavvali	कावावली	कव्वाली
qawwali	क़वावली	कव्वाली
kashton	काष्टों	कष्टों
kasarat	कसररत	कसरत
kasrat	कसररत	कसरत
kasara	कसरार	कसारा
kasida	कसीदा	कसीदा
kahane	कहाेे	कहने
kahne	कहने	कहने
kahlaya	कहलाया	कहलाया
kahaniyon	कहनियों	कहानियों
kile	किले	क़िले
kanji	कंजजी	कांजी
cant	कैंट	कांट
kant	कांट	कांट
kanti	कांटी	कांति
kakoo	काकू	काकू
kaku	काकू	काकू
kaagaj	कागज	कागज़
kaagaz	कागज़	कागज़
kagaj	कागज	कागज़
kagaz	काग़ज	कागज़
kaaji	काजी	काजी
kaji	काजी	काजी
kazi	काजी	काजी
qazi	काजीी	काजी
kajoo	काजू	काजू
kaju	काजू	काजू
kapadi	कपाड़ी	कापड़ी
kapdi	कपड़ी	कापड़ी
kamraj	कामराज	कामराज
kamottejana	कामोत्तेजना	कामोत्तेजना
kamottejna	कामोत्तेजना	कामोत्तेजना
kailana	कैलाा	कायलाना
kaylana	कायलाा	कायलाना
carfi	कारफफ	कार्की
karki	कारकी	कार्की
kartik	कार्तिक	कार्तिक
karyakartaon	कार्यकर्ताओं	कार्यकर्ताओं
karykartaaon	कार्यकारताओं	कार्यकर्ताओं
karykartaon	कार्यकारताओं	कार्यकर्ताओं
karyabhar	कार्यभभर	कार्यभार
karybhar	कार्यभभर	कार्यभार
karyarat	कार्यारत	कार्यरत
karyrat	कार्यरत	कार्यरत
kaalpi	कालपी	कालपी
kalapi	कलापी	कालपी
kalpi	कल्पी	कालपी
kalika	कालिकाा	कालिका
kalighat	कालीघाट	कालीघाट
coldvel	कॉल्डवेल	काल्डवेल
kaldvel	कलल्ववेल	काल्डवेल
kaldwell	कलल्ववेल	काल्डवेल
kaav	काव	काव
kav	काव	काव
kaasht	काष्ट	काश्त
kasht	काष्ट	काश्त
kasim	कसीमम	कासिम
qasim	कसीमम	कासिम
kasimabad	कासीमाबाद	कासिमाबाद
kiya	किया	किया
kiliyan	किलियां	किलियन
killat	किल्लट	किल्लत
killi	किलीली	किल्ली
kisaani	किसानी	किसानी
kisani	किसनी	किसानी
kisanon	किसनों	किसानों
keede	कीडे	कीड़े
kide	कीद़े	कीड़े
keynote	कीनोट	कीनोट
kinote	किनोट	कीनोट
kiratpur	किरतपुर	कीरतपुर
kundal	कुंडल	कुंडल
kundaliya	कुंदलीय	कुंडलियाँ
kundaliyan	कुंदलियां	कुंडलियाँ
kutta	कुट्ता	कुत्ता
kuposhit	कुपोषित	कुपोषित
kumau	कुमौऊ	कुमाऊ
kumavat	कुमावत	कुमावत
kumawat	कुमावत	कुमावत
kural	कुरल	कुराल
kurmi	कुर्मी	कुर्मी
kursiyon	कुर्सियों	कुर्सियों
kush	कुश	कुश
kushaan	कुशान	कुषाण
kushan	कुशान	कुषाण
kusumalataa	कुसुमललता	कुसुमलता
kusumalta	कुसुमलता	कुसुमलता
kusumlata	कुसुमलता	कुसुमलता
koot	कूट	कूट
kut	कूट	कूट
kritika	कृतिकिका	कृतिका
kpo	कपपो	केपीओ
canterbari	कैंटरबरी	कैंटरबरी
canterbury	कैंटरबरी	कैंटरबरी
candidate	कैंडीडेट	कैंडिडेट
katrina	कत्रीना	कैटरीना
caitlyn	कैटलिं	कैटलिन
cateline	कैटलाइन	कैटलिन
catlin	कैटलिन	कैटलिन
cadmium	कैडमिययम	कैडमियम
catholic	कैथलिक	कैथोलिक
catholicon	कैथलिकों	कैथोलिकों
kaetholikon	कैथोलिकों	कैथोलिकों
capacitor	कैपासिटर	कैपेसिटर
carat	कारत	कैरेट
cavity	केविटी	कैविटी
cavalry	केवलरी	कैवेलरी
kaivelari	कैवेलारी	कैवेलरी
complex	कंप्लेक्स	कॉम्प्लेक्स
kocchi	कोचीची	कोच्चि
kochi	कोची	कोच्चि
corridor	कॉरिडोर	कोरिडोर
corolla	कोरोला	कोरोला
korola	कोरोला	कोरोला
caolan	कॉलन	कोलन
colan	कोलन	कोलन
colon	कोलों	कोलन
calling	कॉलिंग	कोलिंग
koling	कोलिंग	कोलिंग
colorado	कलरडडो	कोलोराडो
kolorado	कोलोरडडो	कोलोराडो
kaushal	कौशल	कौशल
kaushalata	कौशलताा	कौशलता
kaushalta	कौशलता	कौशलता
kaushambi	कौशंबी	कौशाम्बी
cute	कटट	क्यूट
quete	क्विट	क्यूट
cube	क्यूब	क्यूब
cubeck	कब्बेक	क्यूबेक
quebec	क्वाबेक	क्यूबेक
cubes	कब्बेस	क्यूब्स
krantiyon	क्रांतियों	क्रांतियों
cric	क्रिक	क्रिक
crick	क्रिक	क्रिक
cricket	क्रिकेट	क्रिकेट
cricketer	क्रिकीटर	क्रिकेटर
cricketing	क्रिकटिंग	क्रिकेटिंग
kriyayog	क्रियायोग	क्रियायोग
christian	क्रिस्टियन	क्रिश्चयन
kruger	क्रुगर	क्रूगर
craig	क्रेंग	क्रेग
creg	क्रेग	क्रेग
cradle	क्रेडल	क्रैडल
chrom	क्रोम	क्रोम
chrome	क्रोम	क्रोम
client	क्लाइंट	क्लांइट
clock	क्लॉक	क्लाक
clasen	क्लासनन	क्लासें
classen	क्लासेन	क्लासें
classon	क्लासों	क्लासों
clay	क्ले	क्ले
claris	क्लारिस	क्लेरिस
cleris	क्लेरिस	क्लेरिस
clerys	क्लेरीस	क्लेरिस
quantico	क्वांटिको	क्वांटिको
queens	क्वींस	क्वींस
kshitij	क्षितिज	क्षितिज
shitij	शीतिजिज	क्षितिज
kshin	क्षीन	क्षीण
shin	शीन	क्षीण
kshetron	क्षेत्रों	क्षेत्रों
shetron	क्षत्रों	क्षेत्रों
khand	खांड	खंडा
khanda	खांडा	खंडा
khachakhach	खच्खच	खचाखच
khajarana	खजजराा	खजराना
khajraana	खजराना	खजराना
khajrana	खजराना	खजराना
khatakati	खटकती	खटकती
khatakti	खटकती	खटकती
kihatkati	किहतकती	खटकती
khattapan	खट्तपपान	खट्टापन
khat	खाट	खत
khani	खानी	खनि
khanik	खानिक	खनिक
khanikarm	खानककर्म	खनिकर्म
khanikarma	खानककर्मा	खनिकर्म
khanikarmi	खानककर्मी	खनिकर्म
khapat	खपटत	खपत
khariya	खरिया	खरिया
khalnayak	खलनायक	खलनायक
khaaskar	खास्कर	ख़ासकर
khaskar	खस्कर	ख़ासकर
khaastaur	खासतौर	ख़ासतौर
khastaur	खासतौर	ख़ासतौर
khaibar	खैबर	ख़ैबर
khyber	खैबरर	ख़ैबर
khaein	खाएं	खाएं
khaen	खां	खाएं
khayen	खाएें	खाएं
khaate	खाते	खाते
khaatey	खाते	खाते
khate	खाते	खाते
khal	खलल	खाल
khinchakar	खींचकर	खिंचकर
khinchkar	खींचकर	खिंचकर
khilana	खिलना	खिलाना
khinchkar	खींचकर	खींचकर
khuda	खुद़ा	खुदा
khudai	खुदाई	खुदाई
khurapka	खुरपपका	खुरपका
khurpaka	खुरपका	खुरपका
khurasan	खुरससनन	खुरासान
khushiyan	खुशियां	खुशियां
khene	खेने	खेने
khaini	खैनी	खैनी
khairati	खैरती	खैराती
khoikhoi	खोईखोई	खोईखोई
khoya	खोया	खोया
gangrel	गैंग्रे	गंगरेल
gangaajal	गंगाजल	गंगाजल
gangajal	गंगाज	गंगाजल
gandaki	गंडककी	गंडकी
gandki	गंडकी	गंडकी
gandh	गंंध	गंध
gandha	गंधा	गंध
gae	गाई	गए
gaye	गाय	गए
gajara	गजजरा	गजरा
gajra	गजजरा	गजरा
gadkar	गड़कर	गडकर
ganapati	गणपती	गणपति
ganpati	गणपती	गणपति
gatisheel	गतिशील	गतिशील
gatishil	गतिशिल	गतिशील
gatishilata	गतिशीलता	गतिशीलता
gadadhar	गदाधर	गदाधर
gammat	गम्मत	गम्मत
gaya	गाया	गया
garibi	गरीबी	गरीबी
garjana	गर्जना	गर्जना
galgand	गललंंड	गलगंड
gahmagahmi	गहमागहमी	गहमागहमी
gemhagehmi	जेमहागहहम	गहमागहमी
ganguly	गंगुल्य	गांगुली
gaanth	गांठ	गांठ
ganth	गंठ	गांठ
gaanthe	गांठे	गांठे
ganthe	गंठे	गांठे
ganthen	गंठें	गांठें
ganthon	गंथों	गांठों
gaen	गाएं	गाएं
gayen	गाएं	गाएं
gazi	गजजी	गाज़ी
gajipur	गाजीीपुर	गाजीपुर
gazipur	गज़ीीपुर	गाजीपुर
gayatri	गययत्री	गायत्री
gayitri	गैयित्री	गायत्री
gaytri	गायत्री	गायत्री
gidgidate	गिडगीडेड	गिड़गिड़ाते
ginate	गिनते	गिनते
ginte	गिंटे	गिनते
girkar	गिरकार	गिरकर
girijaghar	गिरिजाघर	गिरजाघर
girjaghar	गिरजाघर	गिरजाघर
girijagharon	गिरिजाघरों	गिरजाघरों
girjagharon	गिरजाघरों	गिरजाघरों
girati	गिरती	गिरती
girti	गिरती	गिरती
girish	गिरीश	गिरीश
guan	गुआन	गुआन
gujar	गुजरर	गुजार
gujarata	गुजराता	गुजारता
gujarta	गुजरता	गुजारता
gujarate	गुजराते	गुजारते
gujarte	गुजरते	गुजारते
gujarana	गुजरान	गुजारना
gujarna	गुजरना	गुजारना
gujara	गुजराा	गुजारा
gujare	गुजरे	गुजारे
gutta	गुट्ता	गुट्टा
gthalidar	गृलीदार	गुठलीदार
guthalidar	गुथलीदार	गुठलीदार
gudna	गुदना	गुदना
gumaan	गुमान	गुमान
guman	गुमान	गुमान
gulshan	गुलशान	गुलशन
gunga	गूंगा	गूंगा
grihnagar	गृहणार	गृहनगर
gruhnagar	गृहणगर	गृहनगर
galaxion	गैलक्सियों	गैलेक्सियों
galaxiyon	गैलक्सियों	गैलेक्सियों
galaxyon	गैलक्स्यों	गैलेक्सियों
gochar	गोचार	गोचर
gouchar	गौचार	गोचर
godara	गोडारा	गोदारा
gopichand	गोपीचंद	गोपीचंद
gomake	गोमके	गोमके
gomke	गोमके	गोमके
goel	गोएल	गोयल
goyal	गोयल	गोयल
gosvaami	गोस्वामी	गोस्वामी
gosvami	गोस्वामी	गोस्वामी
goswami	गोस्वामी	गोस्वामी
gaumukh	गौमुख	गौमुख
gomukh	गोमुख	गौमुख
gaumutr	गौमूत्र	गौमूत्र
gaumutra	गौमुत्र	गौमूत्र
gowmutra	गोममत्र	गौमूत्र
granthiyaan	गृणठियां	ग्रंथियां
granthiyan	गृणठियां	ग्रंथियां
grandhiyon	गृणंधियों	ग्रंथियों
granthiyon	गृणठियों	ग्रंथियों
greest	ग्रीस्ट	ग्रीस्ट
greist	ग्रेस्ट	ग्रीस्ट
grist	ग्रिस्ट	ग्रीस्ट
greg	ग्रेग	ग्रेग
granite	ग्रेनाइट	ग्रेनाइट
grenite	ग्रेनाइट	ग्रेनाइट
grandson	ग्रांडसों	ग्रैंडसन
gross	ग्रॉस	ग्रॉस
ghataatop	घटाटोप	घटाटोप
ghatatop	घटटटोप	घटाटोप
ghataayaa	घटाया	घटाया
ghataya	घटाया	घटाया
ghanakar	घनकर	घनाकार
ghabrahat	घबररहट	घबराहट
ghasi	घासी	घासी
ghisai	घिसाई	घिसाई
ghisi	घिसी	घिसी
ghise	घिसे	घिसे
ghumakkadi	घुमक्कड़ी	घुमक्कड़ी
ghumakkdi	घुमक्कड़ी	घुमक्कड़ी
ghumakkadon	घुमक्कड़ों	घुमक्कड़ों
ghumakkaron	घूमक्कारों	घुमक्कड़ों
ghumakkdon	घुमक्कडों	घुमक्कड़ों
ghummakkadon	घूम्मक्कडों	घुमक्कड़ों
ghumaan	घुमान	घुमाण
ghuman	घूमान	घुमाण
ghoonsa	घूंसा	घूंसा
ghunsa	घुंसा	घूंसा
ghongha	घोंघा	घोंघा
ghontane	घोंटने	घोंटने
ghontne	घोंटने	घोंटने
ghot	घोट	घोट
ghodi	घोड़ी	घोड़ी
ghost	घोस्त	घोस्ट
changul	चंगुल	चंगुल
chand	चंद	चंद
chandan	चंदनान	चंदन
chandana	चंदना	चंदन
chandu	चंदुु	चंदू
chandon	चंदों	चंदों
chandrabali	चंद्रबली	चंद्रबली
chandramaon	चंद्रमाओं	चंद्रमाओं
chakatte	चकटते	चकत्ते
chaktte	चकतते	चकत्ते
chakkar	चक्कार	चक्कर
chkkar	चकककर	चक्कर
chakshu	चक्षु	चक्षु
chatagaon	चटागांव	चटगांव
chatgaon	चतगाांव	चटगांव
chadhane	चढ़ाने	चढ़ने
chadhne	चढ़ने	चढ़ने
chaturdik	चाुुर्दिक	चतुर्दिक
chatunshkoniy	चतुंुककोणीय	चतुष्कोणीय
chatushkoniy	चतुषुक्णीय	चतुष्कोणीय
chatushkoniya	चतुष्कोणीय	चतुष्कोणीय
channa	चन्ना	चन्ना
chabate	चबतते	चबाते
chabutare	चबूतरे	चबूतरे
chabutre	चाबूतेरे	चबूतरे
chamakna	चमकना	चमकना
chamkana	चमकाना	चमकना
charas	चररस	चरस
charit	चरित	चरित
charcha	चर्चा	चर्चा
churcha	चर्चा	चर्चा
charchaon	चर्चाओं	चर्चाओं
chalenge	चलेंगे	चलेंगे
chlenge	च्लेंग	चलेंगे
chahunaur	चाहुनौर	चहुंओर
chahunor	चाहुनोर	चहुंओर
chanval	चाववाल	चांवल
chanwal	चाववल	चांवल
chachaji	चचाीज	चाचाजी
chadar	चादर	चादर
chadaron	चादारों	चादरों
chadron	चादरों	चादरों
chan	चनन	चान
chanan	चननन	चानन
chaplusi	चापलुसी	चापलूसी
chayal	चायल	चायल
char	चार	चार
charon	चारों	चारों
charge	चार्ज	चार्ज
chart	चररतट	चार्ट
charton	चर्तों	चार्टों
charts	चार्ट्स	चार्ट्स
chaalit	चालित	चालित
chalit	चलित	चालित
chikitsak	चिकितिस्सक	चिकित्सक
chikitsakon	चिकितिस्कों	चिकित्सकों
chikhali	चिखली	चिखली
chiththi	चित्ठी	चिट्ठी
chitthi	चित्ठी	चिट्ठी
chithhi	चिती	चिठ्ठी
chiththi	चित्ठी	चिठ्ठी
chitthi	चित्ठी	चिठ्ठी
chidchidapan	चिड़चिड़ापन	चिडचिडापन
chidchidapan	चिड़चिड़ापन	चिड़चिड़ापन
chidhate	चिढ़ते	चिढ़ते
chidhte	चिढ़ते	चिढ़ते
chithrkar	चित्रकार	चित्रकार
chitrkar	चित्रकार	चित्रकार
chipakane	चिपकाने	चिपकने
chipakne	चिपकने	चिपकने
chipkane	चिपकाने	चिपकने
chimati	चिमती	चिमटी
chimti	चिमटी	चिमटी
chillane	चिलालन	चिल्लाने
chee	छी	ची
chi	ची	ची
chuka	चूका	चुका
chune	चुने	चुने
chunar	चुनार	चूनर
changed	चांगेड	चेंज्ड
chetti	चेटीती	चेट्टी
chennai	चेन्ाई	चेन्नई
chero	चेरो	चेरो
chest	चेस्ट	चेस्ट
championship	चैप्िशशशप	चैंपियनशिप
chor	चोर	चोर
choro	चोरो	चोरों
choron	चोरों	चोरों
chauk	चौक	चौक
chowk	चौक	चौक
chauka	चौका	चौका
chuka	चूका	चौका
chaukiyan	चौकियां	चौकियां
chauki	चौकी	चौकी
chaukhate	चौखते	चौखटे
chauguni	चौगुनी	चौगुनी
chauda	चौड़ा	चौड़ा
chaudah	चौदह	चौड़ा
chaudahavan	चौदहवां	चौदहवां
chaudhavan	चौधवानन	चौदहवां
chaudhawan	चौधवानन	चौदहवां
chaupati	चौपति	चौपाटी
chupaty	चुपत्य	चौपाटी
chaupal	चौपाल	चौपाल
chaurai	चौराई	चौरई
chausinga	चौसिंगा	चौसिंगा
chausingha	चौसिंघ	चौसिंगा
chhagan	छागन	छगन
chhabi	छबबी	छबि
chhalla	छल्ला	छल्ला
chhallaa	छल्ला	छल्ला
chhaviyaan	छािियां	छवियाँ
chhaviyan	छावियां	छवियाँ
chhavi	छावी	छवी
cheh	छेह	छह
chhah	छाह	छह
chehon	चेहों	छहों
chhahon	छाहों	छहों
chhai	छा	छाई
chhagla	छगला	छागला
chhajan	छजनन	छाजन
chhaati	छाती	छाती
chhati	छती	छाती
chhaapemaar	छापेमार	छापेमार
chhapemar	छापीमर	छापेमार
chheenk	छींक	छींक
chhink	छिंक	छींक
chink	चिंक	छींक
chenkein	चेंकें	छींके
chhekein	छेकें	छींके
chhinke	छिनके	छींके
chhinky	छिंकीय	छींके
chinke	चिंके	छींके
chhudaane	छुड़ाने	छुडाने
chhudane	छुड़ाने	छुडाने
chhupakar	छुपाकर	छुपकर
chhupkar	छुपकरर	छुपकर
chhupkr	छुपक्र	छुपकर
chhupata	छुपता	छुपता
chhupta	छुप्ता	छुपता
chhuptaa	छुप्ता	छुपता
chhura	छूरा	छुरा
chhuraa	छुरा	छुरा
chhuree	छुरी	छुरी
chhuri	छुड़ी	छुरी
chhure	छूरे	छुरे
chhootane	छूटने	छूटने
chhutane	छुटनने	छूटने
chhutne	छुटने	छूटने
chheter	छेतर	छेत्र
chhetr	छेत्र	छेत्र
chhetter	छेत्टर	छेत्र
chhetri	छेत्री	छेत्री
chhetthari	छेत्ठरी	छेत्री
chhetthri	छेत्ठरी	छेत्री
chai	चाय	छै
chhai	छा	छै
chhe	छे	छै
jagaega	जगाएगा	जगाएगा
jagayega	जगाएगा	जगाएगा
jaghaega	जगाएगा	जगाएगा
jgaayega	जगाएगा	जगाएगा
jgayegaa	जगाएगा	जगाएगा
jajaon	जजजाओं	जजों
jajon	जजजों	जजों
jad	जड़	जड़
jadd	जड्द	जड़
jaddit	जद्दित	जड़ित
jadeite	जड़ेत	जड़ित
jadet	जड़ेत	जड़ित
jadit	जड़ित	जड़ित
jadein	जड़ें	जड़ें
jaden	जड़ें	जड़ें
jatara	जतारा	जतरा
jatra	जातरर	जतरा
jataati	जताती	जताती
jatatee	जताती	जताती
jatati	जताती	जताती
janagananaa	जनगनना	जनगणना
janaganna	जनगगननन	जनगणना
jangadnaa	जंगड़ना	जनगणना
janganana	जागानना	जनगणना
janganna	जागनननना	जनगणना
janajagran	जनजागरर	जनजागरण
janjaagran	जनजाग्र	जनजागरण
janjagran	जनजाग्र	जनजागरण
january	जानुरी	जनवरी
janahaani	जनहानन	जनहानि
janahani	जनहहनन	जनहानि
janhaani	जन्हानी	जनहानि
janhani	जन्हानी	जनहानि
jnhaani	जनहानी	जनहानि
jamaate	जमाते	जमाती
jamaati	जमाती	जमाती
jamati	जमाती	जमाती
jamaaya	जमाया	जमाया
jamaeya	जमाया	जमाया
jamaya	जमाया	जमाया
jamayaa	जमाया	जमाया
jamuai	जमुआई	जमुई
jamuei	जमुए	जमुई
jamui	जमुई	जमुई
jai	जाई	जय
jay	जयय	जय
jaidayal	जैदायल	जयदयाल
jayadayal	जययायल	जयदयाल
jaydayal	जयदायल	जयदयाल
jaibaan	जयबान	जयबाण
jaiban	जययबन	जयबाण
jaybaan	जयबान	जयबाण
jayalalita	जययलिताा	जयललिता
jayalalitaa	जययलिता	जयललिता
jayalalithaa	जयललीता	जयललिता
jaylalita	जयललितता	जयललिता
jarakh	जरख	जरख
zarakh	जरख	जरख
jarda	जर्ाा	जर्दा
jardaa	जर्दा	जर्दा
zarda	जर्ाा	जर्दा
jalagati	जलगतती	जलगति
jalgati	जलगती	जलगति
jalgti	जलगती	जलगति
jalte	जलते	जलते
jalbharav	जलभररव	जलभराव
jalbhraav	जलभराव	जलभराव
jalbhrav	जलभराव	जलभराव
jalvaayu	जलवायु	जलवायु
jalvayu	जलवायु	जलवायु
jalesar	जलेसर	जलेसर
jasmeet	जससमीत	जसमीत
jasmit	जससमित	जसमीत
jassee	जसससी	जस्सी
jassi	जसससी	जस्सी
jamaanaa	जमाना	ज़माना
jamana	जमानना	ज़माना
zamaanaa	जमानना	ज़माना
zamana	जमानना	ज़माना
jaljale	जलजले	ज़लज़ले
zalzale	जलजले	ज़लज़ले
zee	जीई	ज़ी
jubaan	जुबान	ज़ुबान
juban	जुबान	ज़ुबान
zuban	जुबान	ज़ुबान
jaanch	जांच	जाँच
jaaunch	जांच	जाँच
janch	जांच	जाँच
jaunch	जौंच	जाँच
jaagriti	जागृति	जागृति
jagriti	जगरीति	जागृति
jagruti	जगगरति	जागृति
jajamau	जजमाऊऊ	जाजमऊ
jajmau	जजममौ	जाजमऊ
jajmauu	जजममऊ	जाजमऊ
jaat	जाट	जात
jat	जटट	जात
jaatak	जाटक	जातक
jatak	जटक	जातक
jaatakon	जाटकों	जातकों
jaatkon	जाटकों	जातकों
jatakon	जटकों	जातकों
jaatiyon	जातियों	जातियों
jatiyon	जातियोो	जातियों
jaankaaron	जानकारों	जानकारों
jaankaron	जानकरों	जानकारों
jankaron	जानकरों	जानकारों
jaanam	जानम	जानम
janam	जन्म	जानम
jaayke	जायके	जायके
jayke	जायके	जायके
jaawar	जावर	जावर
zawar	जवावर	जावर
jing	जिंग	जिंग
gin	गिन	जिन
jeen	जीन	जिन
jin	जीन	जिन
ginee	गिनी	जिनी
jinee	जिनी	जिनी
jini	जिनी	जिनी
geneva	जेनेवा	जिनीवा
jeneva	जेनेवा	जिनीवा
jiniva	जिनिवा	जिनीवा
gypsy	जिप्सी	जिप्सी
jimme	जिम्मे	जिम्मे
jiya	जिया	जिया
gic	गीस	जीआईसी
gr	ग्र	जीआर
gm	गीएम	जीएम
gsm	गीससएम	जीएसएम
gtod	गतटोड़	जीतोड़
gtor	ग्टोर	जीतोड़
jeetod	जीतोड़	जीतोड़
jitod	जीतोड़	जीतोड़
jean	जेन	जीन
jeen	जीन	जीन
jin	जीन	जीन
jeenon	जीनों	जीनों
jinon	जीनों	जीनों
jeepney	जीपने	जीपनी
jipani	जीपानी	जीपनी
jeeyo	जीयो	जीयो
jio	जियो	जीयो
jiyo	जियो	जीयो
jeera	जीरा	जीरा
jira	जीरा	जीरा
jeevant	जीवंत	जीवंत
jivant	जीवंत	जीवंत
jeevan	जीवन	जीवन
jeewan	जीवनन	जीवन
jivan	जीवन	जीवन
jiwan	जीवनन	जीवन
jeevanshaili	जीवनशैली	जीवनशैली
jivanshaili	जीवनशैली	जीवनशैली
jeevniyaan	जीवनियां	जीवनियां
jivaniya	जीवनीय	जीवनियां
jivaniyaan	जीवनियां	जीवनियां
jivaniyan	जीवनियां	जीवनियां
jeevraaj	जीवराज	जीवराज
jivraj	जीवराज	जीवराज
jua	जुआ	जुए
jue	जुए	जुए
juye	जुए	जुए
jutee	जुती	जुटी
juti	जुटी	जुटी
judaai	जुड़ाई	जुड़ाई
judae	जुड़ाई	जुड़ाई
judai	जुड़ईई	जुड़ाई
judaai	जुड़ाई	जुदाई
judai	जुड़ईई	जुदाई
junoon	जुनून	जुनून
junun	जुनून	जुनून
junooni	जूनूनी	जुनूनी
jununi	जुनूनी	जुनूनी
jubair	जुबैैर	जुबेर
juber	ज़ुबेर	जुबेर
zubair	जुुैैर	जुबेर
juraab	जुराब	जुराब
jurab	जुरब	जुराब
julaahon	जुलाहों	जुलाहों
julahon	जूलाहों	जुलाहों
julmon	जुल्मों	जुल्मों
zulmon	जुल्मों	जुल्मों
jood	जूड़	जूड
jud	जुड़	जूड
junagadh	जूनागढ़	जूनागढ
junagarh	जूनागढ़	जूनागढ
junior	जुयियर	जूनियर
jealous	जीलूस	जूलूस
juloos	जुलूस	जूलूस
julus	जुलूस	जूलूस
jetha	जेठा	जेठा
jenner	जेनर	जेनर
generic	जेनेरिक	जेनरिक
jenrick	जेनरिक	जेनरिक
generat	जनररटट	जेनरेट
generate	जनरेट	जेनरेट
jenee	जेनी	जेनी
jenni	जेनीनी	जेनी
jenny	जेनी	जेनी
james	जम्स	जेम्स
jeremy	जेरेमी	जेरेमी
gerome	जेरोम	जेरोम
jerome	जररोम	जेरोम
jacks	जैक्स	जैक्स
jain	जैन	जैन
gene	गेने	जैने
jaine	जैने	जैने
jaino	जैनो	जैनों
jainon	जैनों	जैनों
jerry	जेरी	जैरी
jasper	जस्पर	जैस्पर
jogging	जोगिंग	जॉगिंग
johnson	जॉन्सन	जॉनसन
jobs	जॉब्स	जॉब्स
jockey	जॉकी	जोकि
joki	जोकी	जोकि
jokhim	जोखिम	जोखिम
joddta	जोड़डता	जोड़ता
jodta	जोड़ता	जोड़ता
jorhta	जोड़ता	जोड़ता
jodiyon	जोड़ियों	जोड़ियों
jodo	जोड़ो	जोड़ो
jaun	जौन	जौं
gyatavya	ज्ञातव्य	ज्ञातव्य
gyatvy	ज्ञात्वय	ज्ञातव्य
gyapit	ज्ञापित	ज्ञापित
jyotiba	ज्योतिबा	ज्योतिबा
joint	जॉइंट	ज्वाइंट
jvar	ज्वार	ज्वार
jwar	ज्वार	ज्वार
jvaaron	ज्वारों	ज्वारों
jvaron	ज्वरों	ज्वारों
jwaron	ज्वारों	ज्वारों
jewellers	ज्वैलर्स	ज्वेलर्स
jh	झ	झ
jha	झा	झ
jhalakti	झलकती	झलकती
jhalkati	झलकती	झलकती
jhalla	झल्ला	झल्ला
jhankana	झाकाा	झांकना
jhankna	झाककना	झांकना
jheel	झील	झील
jhil	झील	झील
jheelon	झीलों	झीलों
jhilon	झीलों	झीलों
jhuthala	झुठला	झुठला
jhuthla	झुठला	झुठला
jhuthalane	झुठलनन	झुठलाने
jhuthlane	झुठलान	झुठलाने
tankaar	टंकार	टंकार
tankar	टैंकर	टंकार
takara	तकााा	टकरा
takra	टकरा	टकरा
takaraon	टकराओं	टकरावों
takravon	टकरावों	टकरावों
tapakti	तपकती	टपकती
tapkati	तपकतीी	टपकती
time	टायम	टाइम
timer	टाइमर	टाइमर
taoo	ताऊ	टाऊ
tau	ताऊ	टाऊ
tapoowo	तपपवो	टापुओं
tapuon	तपुओं	टापुओं
tapuwo	तपूवूव	टापुओं
tied	टायड	टायर्ड
tired	तारेद	टायर्ड
tyred	टायरेड	टायर्ड
tarch	तर्च	टार्च
torch	टॉर्च	टार्च
tik	टीक	टिक
teap	टीप	टिप
tip	टीप	टिप
tippanikar	तिप्पणिकार	टिप्पणीकार
tippnikar	तिप्पिनकार	टिप्पणीकार
tivolee	तिवोली	टिवोली
tivoli	तिवोली	टिवोली
teekamgarh	तीकामगढ़	टीकमगढ़
tikamgarh	तीकामगढ़	टीकमगढ़
teekon	टीकों	टीकों
tikon	टीकों	टीकों
two	ट्वो	टु
tension	टेंशन	टेंशन
tenis	टेनिस	टेनिस
tennis	टेनिस	टेनिस
taste	तससते	टेस्ट
test	टेस्ट	टेस्ट
tasting	टसस्तिंग	टेस्टिंग
testing	टेस्टिंग	टेस्टिंग
tainin	तैनीन	टैनिन
tenin	टेनिन	टैनिन
tanish	तनीीश	टैनिस
tennis	टेनिस	टैनिस
taboo	तबबू	टैबू
taiboo	ताईबू	टैबू
taobao	ताबबाव	टैबू
tonic	टोनिक	टॉनिक
tonga	तोंगा	टोंगा
toka	टोका	टोका
tuesday	ट्यूज्	ट्यूजडे
tuning	ट्यूनिंग	ट्यूनिंग
tuberculosis	टबुबररकूलोसिस	ट्यूबरक्यूलोसिस
tuberkyulosis	टबुबररक्यूलोसिस	ट्यूबरक्यूलोसिस
truck	ट्रॉक	ट्रक
trangistor	ट्रांजिस्टर	ट्रांजिस्टर
tranjister	ट्रांजिस्टर	ट्रांजिस्टर
transistor	ट्रांसिस्टर	ट्रांजिस्टर
transfer	ट्रांसफर	ट्रान्सफर
tribunal	ट्रिबुनल	ट्रिब्युनल
tribunal	ट्रिबुनल	ट्रिब्यूनल
trubyunal	ट्रूब्यूनल	ट्रिब्यूनल
truth	तृथ	ट्रुथ
tuth	तूठ	ट्रुथ
traded	ट्रेडेड	ट्रेडेड
trabal	ट्राबल	ट्रेबल
trebal	ट्रेबल	ट्रेबल
trouble	ट्रबल	ट्रेबल
traip	ट्रैप	ट्रैप
trap	ट्रैप	ट्रैप
trot	ट्रॉट	ट्रॉट
trott	ट्रॉट	ट्रॉट
thakkar	थक्कार	ठक्कर
thakkr	थक्कर	ठक्कर
thaharne	ठहररने	ठहरने
thahrane	ठहराने	ठहरने
theharne	ठहररने	ठहरने
thikane	ठिकाने	ठिकाने
thumari	थममरी	ठुमरी
thumri	थमरीी	ठुमरी
theinga	थेंगा	ठेंगा
thenga	ठेंगा	ठेंगा
thengaa	ठेंगा	ठेंगा
daglas	दागलास	डगलस
douglas	दौगलास	डगलस
dabhara	दाभरा	डभरा
dabhra	दाभरा	डभरा
dabhoi	दभभईई	डभोई
dam	दमम	डम
dum	दमम	डम
darate	डरते	डराते
daratey	दरते	डराते
daravani	दरवानी	डरावनी
darawani	दरवानी	डरावनी
dravani	द्रवानी	डरावनी
down	दान	डाउन
daak	दाक	डाक
dak	दक	डाक
daka	दकाा	डाका
dabi	दबी	डाबी
dabolim	दबोलिम	डाबोलिम
dinosaur	दिनोसौर	डायनासोर
diaries	डायरीज	डायरीज
dit	दित	डिट
depthiriya	देप्थिरीय	डिप्थीरिया
diphtheria	डिफ्थथरियाया	डिप्थीरिया
de	दे	डीई
dealership	डीलर्शिप	डीलरशिप
dvc	ड्वीसी	डीवीसी
dubaana	दुबाना	डुबाना
dubana	दुबना	डुबाना
dubona	डूबोना	डुबोना
dulne	दुलने	डुलने
doonarpur	दूनररपुर	डूंगरपुर
doongarpur	दूंगरपुर	डूंगरपुर
dungarpur	दुंगरपुर	डूंगरपुर
dungerpur	दंगरपुर	डूंगरपुर
dubana	दुबना	डूबना
dubna	दुबना	डूबना
dangerous	डांगेरसस	डेंजरस
daisy	दैस्य	डेजी
dazy	दजजी	डेजी
deji	देजी	डेजी
deputy	डिप्टी	डेप्युटी
davidson	द्विदससन	डेविडसन
devidson	देविडससन	डेविडसन
davey	दावे	डेवी
devi	देवी	डेवी
dewey	देवे	डेवी
destination	डेस्टीनेशन	डेस्टिनेशन
datson	दत्सों	डैटसन
datsun	दत्सून	डैटसन
daddy	दद्दय	डैडी
dark	दर्क	डॉर्क
dork	डॉर्क	डॉर्क
dose	दोस	डोज
domenic	डोमेनिक	डोमेनिक
doranda	दौरंदा	डोरंडा
dolane	दोलनन	डोलने
dolne	डोलने	डोलने
dual	डुएल	ड्युअल
duak	दुक	ड्यूक
duke	दुके	ड्यूक
drame	ड्रमम	ड्रामे
dramen	ड्रमेन	ड्रामे
drager	ड्रेजर	ड्रेजर
dredger	ड्रेजर	ड्रेजर
dreijer	ड्रीजर	ड्रेजर
dhakaal	धकाल	ढकाल
dhakal	धकलल	ढकाल
dhakkal	धक्कल	ढकाल
dhkal	धकलल	ढकाल
dhale	धले	ढले
dhoondh	धूंध	ढूंढ
dhundh	धुंध	ढूंढ
dhoondhata	धूंढता	ढूंढता
dhundhata	धूंढता	ढूंढता
dhundhta	धूंढता	ढूंढता
dhoondhi	धूंधी	ढूंढी
dhundhi	धुंधी	ढूंढी
tanjavur	तंजावूर	तंजावुर
thanjavur	थंजावूर	तंजावुर
tantr	तंं्र	तंत्र
tantra	तंं्र	तंत्र
tantrikao	तंत्रिकाओ	तंत्रिकाओं
tantrikaon	तंत्रिकाओं	तंत्रिकाओं
tantro	तंं्रोो	तंत्रों
tantron	तंत्रों	तंत्रों
tagade	तगड़े	तगड़े
tagde	तगडेे	तगड़े
tadipaar	तादीपार	तड़ीपार
tadipar	तादीपर	तड़ीपार
tani	तानी	तनी
tapan	तापन	तपन
tarafa	तरफफा	तरफा
tarfa	तर्फा	तरफा
tarabganj	तारबगंज	तरबगंज
taras	तारस	तरस
taraash	तराश	तराश
tarash	तारश	तराश
tarashay	ताराशाय	तराशे
tarashe	तररशे	तराशे
tareeko	तरीको	तरीको
tariko	तारकोो	तरीको
tark	तररकक	तर्क
tarkvaad	तर्कवाद	तर्कवाद
tarkvad	तर्कवाद	तर्कवाद
tarkwaad	तर्कवाद	तर्कवाद
tarko	तररकोो	तर्कों
tarkon	तररकों	तर्कों
talabgaar	तलाबगार	तलबगार
talabgar	तललबगार	तलबगार
talbagaar	तलबबागार	तलबगार
talbagar	तलबबागर	तलबगार
talawe	तलावे	तलवे
talve	तालवव	तलवे
talawon	तलावों	तलवों
talvon	तलववों	तलवों
tahakhana	तहखनाा	तहखाना
tahkhaana	तहखाना	तहखाना
tahkhana	तहखाना	तहखाना
taantaa	तांता	तांता
tanta	टांटा	तांता
tambe	तंंबे	तांबे
tanbe	तंंबे	तांबे
taaja	ताजा	ताजा
taajaa	ताजा	ताजा
taaza	ताजा	ताजा
taja	तजजा	ताजा
taza	तजजा	ताजा
tansen	तांसन	तानसेन
taapmaanon	तापमाणों	तापमानों
tapmano	तपममानों	तापमानों
tapmanon	तपममानों	तापमानों
taapti	तापती	ताप्ती
tapti	तपपतती	ताप्ती
tarabai	तरबाई	ताराबाई
taseer	तसीरर	तासीर
tasir	तसीरर	तासीर
taahi	ताही	ताहि
tahi	ताही	ताहि
tikone	टीकोन	तिकोने
tirupati	तिरुपति	तिरूपति
tiwari	तीवारी	तिवारी
ti	टी	ती
teer	तीर	तीर
tir	तीर	तीर
teeron	तीरों	तीरों
tiron	तीरों	तीरों
tirthatan	तीर्थटन	तीर्थाटन
tungnath	तुंगनाथ	तुंगनाथ
tughlaq	तुगलकाक	तुगलक
tuglak	तुग्लाक	तुगलक
tughlakabad	तुगलकाबड़	तुगलकाबाद
tughlaqabad	तुगलकाबा़	तुगलकाबाद
tuglakabad	तुग्लााबड़	तुगलकाबाद
tugalaki	तुगालककी	तुगलकी
tugalki	तुगालककी	तुगलकी
tuglaki	तुगललाकी	तुगलकी
tufail	टुफैल	तुफैल
tejaji	तेजजी	तेजाजी
teji	तेजी	तेजी
tel	तेल	तेल
telon	टेलों	तेलों
to	टो	तो
toh	तो	तो
taul	तौल	तौल
tyohaar	त्योहार	त्यौहार
tyohar	त्योहार	त्यौहार
tyoihar	त्योयाहार	त्यौहार
tyauharon	त्यौहारों	त्यौहारों
tyoharon	त्योहारों	त्यौहारों
tyoiharon	त्योयारों	त्यौहारों
trijata	तृजीजता	त्रिजटा
trijta	तृजताा	त्रिजटा
triya	त्रिया	त्रिया
tremasik	ट्रेमासिक	त्रैमासिक
trimasik	ट्रिमासिक	त्रैमासिक
tse	ट्से	त्से
thaki	ठाकी	थकी
thki	थककी	थकी
tharti	थररती	थर्टी
thirty	थर्ती	थर्टी
thane	थाने	थाणे
thaanvi	थानवी	थानवी
thanvi	थानवी	थानवी
theateron	थीतरों	थिएटरों
theatron	थीत्रों	थिएटरों
theaters	थीटर्स	थिएटर्स
theater	थीटर	थियेटर
theatre	ठीतरे	थियेटर
theateron	थीतरों	थियेटरों
theatron	थीत्रों	थियेटरों
thitron	थित्रों	थियेटरों
theaters	थीटर्स	थियेटर्स
theatrs	थीटर्स	थियेटर्स
thiyeters	थियीटर्स	थियेटर्स
thirake	थिरके	थिरके
thirke	थिरके	थिरके
thief	ठीफ	थीफ
then	थेन	थेन
theni	थेनी	थेनी
thailee	थाइीी	थैली
thaili	थालीी	थैली
thaile	थाइले	थैले
dang	डांग	दंग
danga	दंगा	दंगा
dangon	दांगों	दंगों
dampati	दंपपति	दंपति
danpati	दनपटी	दंपति
dampatiyon	दंपपतियों	दंपतियों
dampattiyon	दंपपत्तियों	दंपतियों
danptiyon	दंपत्िियों	दंपतियों
dadreva	दददरेवा	ददरेवा
dadrewa	दददरेवा	ददरेवा
damoh	दममह	दमोह
dardara	दरददरा	दरदरा
dardraa	दरद्रा	दरदरा
durdhara	दूर्धरा	दरदरा
darmiyaan	दरमियां	दरमियान
darmiyan	दरमियां	दरमियान
darjano	दरजजनों	दर्जनों
darjanon	दरजजनों	दर्जनों
darp	डार्प	दर्प
darra	दररा	दर्रा
dalbadal	दलबबदल	दलबदल
dalbadl	दलबबदल	दलबदल
dali	दलीी	दली
dastaanaa	दस्ताना	दस्ताना
dastana	दससतताना	दस्ताना
dastavej	दस्तावेज	दस्तावेज
dahan	दहान	दहन
dahal	दहलल	दहल
da	दा	दा
daakhil	दाखिल	दाखिल
dakhil	दख़िल	दाखिल
daakhile	दाखीले	दाखिले
dakhile	दख़िेे	दाखिले
daataa	दाता	दाता
data	दाता	दाता
dadari	दादरी	दादरी
daanshil	दानशील	दानशील
danshil	दनशील	दानशील
daabholkar	दाभोलकर	दाभोलकर
dabholkar	दभभोलकर	दाभोलकर
damale	दमले	दामले
damle	डममे	दामले
dayitv	दययित्व	दायित्व
dayitva	दायित्व	दायित्व
dayitwa	दायित्व	दायित्व
dayitvon	दायित्वों	दायित्वों
dayityon	दायतत्यों	दायित्वों
darul	दरुुल	दारूल
daav	दाव	दाव
daaw	दाव	दाव
dav	दाव	दाव
daw	दाव	दाव
daah	दाह	दाह
dah	दहह	दाह
dikhla	दिखला	दिखला
dikhlaa	दिखला	दिखला
dikhaaiye	दिखाइए	दिखाइये
dikhaiye	दिखाइए	दिखाइये
dikhaai	दिखाई	दिखाई
dikhai	दिखाई	दिखाई
dikhayi	दिखायी	दिखाई
dikhaaee	दिखाई	दिखाईं
dikhaai	दिखाई	दिखाईं
dikhaain	दिखाइन	दिखाईं
dikhaee	दिखाई	दिखाईं
dikhai	दिखाई	दिखाईं
dikhayin	दिखाएं	दिखाईं
dikhai	दिखाई	दिखायी
dikhayi	दिखायी	दिखायी
dikhaai	दिखाई	दिखार्इ
dikhae	दिखाए	दिखार्इ
dikhai	दिखाई	दिखार्इ
dikhayi	दिखायी	दिखार्इ
dita	दिता	दिता
ditaa	दिता	दिता
dinaank	दिनांक	दिनांक
dinank	दिनांक	दिनांक
dirham	दीरहहम	दिरहम
dilaaye	दिलाए	दिलाये
dilaye	दिलाए	दिलाये
deewani	दीवानी	दिवानी
diwani	दिवानी	दिवानी
divy	दिव्य	दिव्य
divya	दिव्य	दिव्य
divyata	दिव्यताा	दिव्यता
divya	दिव्य	दिव्या
deepan	दीपान	दीपन
deepn	दीपन	दीपन
dipan	दीपान	दीपन
deepsingh	दीप्सिं	दीपसिंह
dipsingh	डिपससिंह	दीपसिंह
deepika	दीपिका	दीपिका
dipika	दिपिका	दीपिका
deeya	दीया	दीया
diya	दिया	दीया
dukaanon	दुकानों	दुकानों
dukanon	दुकानों	दुकानों
dukke	दुक्के	दुक्के
dukhan	दूखान	दुखन
dukhit	दुखित	दुखित
dukhiyon	दुखियों	दुखियों
dukhon	दूखों	दुखों
dubhashiyon	दुभाषियों	दुभाषियों
durgun	दुर्गुण	दुर्गुण
durghatna	दुर्घटना	दुर्घटना
durghtna	दुर्घटना	दुर्घटना
duneerti	दुनीर्ती	दुर्नीति
durniti	दूर्णिति	दुर्नीति
durbhiksh	दुर्भीक्ष	दुर्भिक्ष
duvidhaaen	दुविधाएं	दुविधाएं
duvidhaayein	दुविधाएं	दुविधाएं
duvidhaen	दुविधाएं	दुविधाएं
duwaidhaayein	दुवैधाएं	दुविधाएं
dune	दुने	दूने
doordarshan	दूरदर्शन	दूरदर्शन
durdarshan	दूरददर्शन	दूरदर्शन
dradh	दृाध	दृढ़
dridh	दृद	दृढ़
dekhoge	देखोगे	देखोगे
denevaali	देनेवाली	देनेवाली
denevali	देनेवाली	देनेवाली
denewaali	देनेवाली	देनेवाली
denewali	देनेवाली	देनेवाली
deonar	डेयनर	देवनार
devnaar	देवनार	देवनार
devnar	देवनार	देवनार
devaapur	देवापुर	देवापुर
devapur	देवापुर	देवापुर
devi	देवी	देवी
devisingh	डेविजसिं	देवीसिंह
devisinh	देविजसिं	देवीसिंह
deshkaal	देशकाल	देशकाल
deshkal	देशकल	देशकाल
deshke	देशके	देशके
desai	देसाई	देसाई
doge	दोगे	दोगे
dvadash	द्वददश	द्वादश
dwaadas	द्वादसस	द्वादश
dvivedi	द्विवेदी	द्विवेदी
dwivedi	द्विवेदी	द्विवेदी
dhande	धंडे	धंधे
dhandhe	धंधे	धंधे
dhndhe	धंधे	धंधे
dhandhon	धंधों	धंधों
dhandon	धंडों	धंधों
dhakelte	धकेलते	धकेलते
dhkelate	धकेलते	धकेलते
dhatana	धााना	धटना
dhatna	धानाा	धटना
dhankuber	धनकुबेर	धनकुबेर
dhanadhany	धनधधन्य	धनधान्य
dhandhaanya	धनधान्य	धनधान्य
dhandhany	धनधन्न्य	धनधान्य
dhandhanya	धन्नन्य	धनधान्य
dhamkaataa	धमकाता	धमकाता
dhamkata	धमकता	धमकाता
dhamm	धम्म	धम्म
dhamma	धम्मा	धम्मा
dhammaa	धम्मा	धम्मा
dharmnath	धर्मनाथ	धर्मनाथ
dharmraj	धर्मराज	धर्मराज
dharmesh	धर्मेश	धर्मेश
dhasmaanaa	धस्माना	धस्माना
dhasmana	धस्माना	धस्माना
dhaak	ढाक	धाक
dhak	ढक	धाक
dhaaga	धागा	धागा
dhaagaa	धागा	धागा
dhaga	धागा	धागा
dhaatuein	धातुएं	धातुएं
dhaatuyein	धातुएं	धातुएं
dhtuen	धतुएं	धातुएं
dhaarak	धारक	धारक
dharak	धराक	धारक
dhaari	धारी	धारी
dhari	धारी	धारी
dhuan	धुआन	धुआं
dhunaai	धुनाई	धुनाई
dhunai	धुनईई	धुनाई
dhuriya	धूरिया	धुरिया
dhuriyaa	धूरिया	धुरिया
dhuni	धुनी	धूनी
dhairyavaan	धैर्यवान	धैर्यवान
dhairyawan	धैर्यवान	धैर्यवान
dhiryavan	धीर्यावन	धैर्यवान
dhiryawaan	धीर्यवान	धैर्यवान
dhokebaaj	धोकेबाज	धोखेबाज
dhokebaaz	धोकेबाज	धोखेबाज
dhokebaj	धोकेबाज	धोखेबाज
dhokebaz	धोकेबाज	धोखेबाज
dhokhebaaj	धोखेबाज	धोखेबाज
dhokhebaj	धोखेबाज	धोखेबाज
dhona	धोना	धोना
dhonaa	धोना	धोना
dhoraaji	धोराजी	धोराजी
dhoraji	धोरजी	धोराजी
dhoron	धोरों	धोरों
dhyeyavaadi	ध्येयवादी	ध्येयवादी
dhyeywadi	ध्येववादी	ध्येयवादी
dyeyvadi	द्येवादी	ध्येयवादी
dhrupad	धृरुप	ध्रुपद
drupad	दृपुप	ध्रुपद
nandanvan	नंदनवान	नंदनवन
nadsa	नादसा	नक्सल
naksal	नक्सल	नक्सल
naxal	नककाल	नक्सल
naksalavaad	नक्सलवाद	नक्सलवाद
naksalwaad	नक्सलवाद	नक्सलवाद
naksalwad	नक्सलवाद	नक्सलवाद
naxalvaaad	नक्लवाद	नक्सलवाद
naxalwaad	नक्लवाद	नक्सलवाद
naksaliyon	नक्सलियों	नक्सलियों
naxaliyon	नककालियों	नक्सलियों
naksali	नक्सली	नक्सली
naxali	नककली	नक्सली
nagaada	नगाड़ा	नगाड़ा
nagaadaa	नगाड़ा	नगाड़ा
nagaaraa	नागरा	नगाड़ा
nageene	नागीन	नगीने
nagine	नाजने	नगीने
najarandaaj	नजररंदाज	नजरंदाज
najarandaaz	नजरअंदाज	नजरंदाज
nazarandaaj	नज़रंदाज	नजरंदाज
nazarandaaz	नजरअंदाज	नजरंदाज
nazarandaz	नजरअंदजज	नजरंदाज
najraane	नजराने	नजराने
nazraane	नजराने	नजराने
najariyon	नजररियों	नजरियों
najriyon	नजरियों	नजरियों
najron	नजरों	नजरों
najeeb	नजीब	नजीब
najib	नजीबब	नजीब
najibabaad	नाजीबाबद	नजीबाबाद
najibabad	नाजीबाबद	नजीबाबाद
najeem	नजीम	नजीम
najim	नजीमम	नजीम
nazeem	नजीीम	नजीम
nana	नाना	नना
nanaa	नाना	नना
nna	न्ना	नना
nanhe	नन्हे	नन्हें
nanhein	नन्हें	नन्हें
nabj	नब्ज	नब्ज़
nabja	नब्जा	नब्ज़
nabz	नब्ज़	नब्ज़
namkeen	नमकीन	नमकीन
namkin	नामकीन	नमकीन
narnaari	नरनारी	नरनारी
narnari	नररारी	नरनारी
narbhakshi	नर्भक्षी	नरभक्षी
naram	नाराम	नरम
narm	नर्म	नरम
narmi	नर्मी	नरमी
narsanhar	नरसंहार	नरसंहार
narsanharon	नरसंहारों	नरसंहारों
november	नोवंबर	नवंबर
navketan	नवकेतन	नवकेतन
navjaagaran	नवजागरण	नवजागरण
navjagran	नवजाग्र	नवजागरण
navdha	नवधा	नवधा
navvadhoo	नववाधू	नववधू
navvadhu	नववधधु	नववधू
nava	नावा	नवा
navaa	नवा	नवा
navate	नवाते	नवाते
navanagar	नवानगर	नवानगर
nawanagar	नवानगर	नवानगर
navya	नव्य	नव्या
naseem	नसीम	नसीम
nasim	नसीमम	नसीम
nights	नाइट्स	नाइट्रस
nitrous	नाइट्रास	नाइट्रस
nineteez	निनेतीज	नाइनटीज
nineties	नानेटीज	नाइनटीज
ninties	निंटीज	नाइनटीज
nau	नौ	नाऊ
nauu	नौऊ	नाऊ
naakaam	नाकाम	नाकाम
nakam	नकम	नाकाम
naagrik	नागरिक	नागारिक
nagarik	नागरिक	नागारिक
nagrik	नागरिक	नागारिक
nagin	नाीन	नागिन
nadep	नेडेप	नाडेप
nanak	नानक	नानक
nanavati	नानवती	नानावती
napane	नापने	नापने
napne	नपपने	नापने
napa	नापा	नापा
naam	नाम	नाम
naamdhari	नामधारी	नामधारी
namdhari	नमधारी	नामधारी
namankano	नममाकननों	नामांकनों
namankanon	नममानकनों	नामांकनों
namavaliyon	नमावलियों	नामावलियों
naamo	नामो	नामो
namo	नमोो	नामो
nayak	नायक	नायक
naraji	नाराजी	नाराजी
naraingarh	नरैंगढ़	नारायणगढ़
narayangadh	नारायागढ़	नारायणगढ़
narayangarh	नारायणगढ़	नारायणगढ़
naasar	नासार	नासर
nahargadh	नहारगढ़	नाहरगढ
nahargarh	नहारगढ़	नाहरगढ
nikalegi	निकालेगी	निकलेगी
nikalogi	निकललोगी	निकलेगी
nikaalani	निकालनन	निकालनी
nikaalni	निकालनी	निकालनी
nikalani	निकालनी	निकालनी
nikalni	निकालनी	निकालनी
nicki	निकी	निकी
nicky	निकी	निकी
niki	निकी	निकी
niketan	निकेतन	निकेतन
nikhar	निखार	निखर
nikhari	निखरी	निखरी
nigar	निगरर	निगर
nigger	नागगर	निगर
nichala	निचला	निचला
nichalaa	निचला	निचला
nichla	निचला	निचला
nitiyon	नितियों	नितियों
nitya	नित्य	नित्या
nityaa	नित्या	नित्या
nidhaan	निधान	निधान
nidhan	निधान	निधान
nipatara	निपटारा	निपटारा
niptaara	निपटारा	निपटारा
niptaaraa	निपटारा	निपटारा
niptara	निपटारा	निपटारा
niyanta	नियंता	नियंता
niyantaa	नियताा	नियंता
niya	निया	निया
niyaa	निया	निया
nirdeshika	निर्देशिका	निर्देशिका
nirdeshikaa	निर्देशिका	निर्देशिका
nirdhaarit	निर्धारित	निर्धारित
nirdharit	निर्धरित	निर्धारित
nirbaadh	निर्ाध	निर्बाध
nirbadh	निर्ाध	निर्बाध
niveshakartaa	निवेशकर्ता	निवेशकर्ता
niveshkarta	निवेशकर्ता	निवेशकर्ता
niveshkartaa	निवेशकर्ता	निवेशकर्ता
nischal	निश्चल	निश्चल
nishchal	निश्चल	निश्चल
nishnaat	निश्नात	निष्णात
nishpaap	निष्पाप	निष्पाप
nihalaani	निहलानी	निहलानी
nihlaani	निहलानी	निहलानी
nihlani	निहलानी	निहलानी
nihaalchand	निहालचंद	निहालचंद
nihalchand	निहालचंद	निहालचंद
neechaaee	नीचाई	नीचाई
nichaai	निचाई	नीचाई
neat	नीट	नीट
neet	नीत	नीट
neetiyon	नीतियों	नीतियों
nitiyon	नितियों	नीतियों
neelagaay	नीलगाय	नीलगाय
nilgai	निलगाई	नीलगाय
neelaabh	नीलाभ	नीलाभ
nilaabh	निलाभ	नीलाभ
nilabh	निलाभ	नीलाभ
nuskhe	नुस्खे	नुस्खे
noon	नून	नून
nun	ननन	नून
noobiyaa	नूबिया	नूबिया
nubiya	नुबिया	नूबिया
nrityashaili	नृत्यशैशलली	नृत्यशैली
nrutyashaili	नृत्यशैलीली	नृत्यशैली
nrityon	नृत्यों	नृत्यों
nrutyon	नृत्यों	नृत्यों
neco	नेको	नेको
neko	नेको	नेको
nectar	नेक्टार	नेक्टर
neg	नेग	नेग
nega	नेगा	नेग
networking	नेटवर्किंग	नेटवर्किग
neto	नेटो	नेटो
neta	नेता	नेता
nemo	नेमो	नेमो
nelsan	नेल्सन	नेल्सन
nelson	नेल्सन	नेल्सन
nations	नेशनस	नेशंस
nehara	नेहरा	नेहरा
nehra	नेहरा	नेहरा
naino	नैनो	नैनो
nano	नानो	नैनो
naivedh	नैवेध	नैवेद्य
naivegh	नैवेघ	नैवेद्य
nevedya	नेवेद्य	नैवेद्य
nominate	नॉमिनेट	नॉमिनेट
naukari	नौकरी	नोकरी
naukri	नौकरी	नोकरी
nokari	नोकरी	नोकरी
nokri	नोकरी	नोकरी
notes	नोट्स	नोट्स
nora	नोरा	नोरा
nori	नोरी	नोरी
nauner	नॉनर	नौनेर
nauvahan	नौवहहन	नौवहन
naushad	नौषद	नौशाद
panchaang	पंचांग	पंचांग
panchang	पांचाग	पंचांग
punchang	पंचंग	पंचांग
punjab	पंजबब	पंजाब
punjabiyon	पुंाबियों	पंजाबियों
pantar	पांतर	पंटर
panter	पंंटर	पंटर
punter	पंटर	पंटर
pakaayein	पकाएं	पकाएं
pakaayen	पकाएं	पकाएं
pakaen	पकाएन	पकाएं
pakayen	पकाएं	पकाएं
pakaude	पकौड़े	पकौड़े
pakshapat	पक्षपात	पक्षपात
pakshpaat	पक्षपात	पक्षपात
pakshpat	पक्षपात	पक्षपात
pagabadha	पगबबढ़ा	पगबाधा
pagbadha	पगबढ़ा	पगबाधा
pagalaa	पगला	पगला
pagla	पगलाा	पगला
pachaataa	पचाता	पचाता
pachata	पछाता	पचाता
patakkar	पटककार	पटककर
patkathaayein	पटकथाएं	पटकथाएं
patkathaein	पटकथाएं	पटकथाएं
patkathayen	पटकथाएं	पटकथाएं
patki	पतकी	पटकी
pataraani	पतरानी	पटरानी
patrani	पतराणी	पटरानी
patavaari	पतवारी	पटवारी
patwari	पतवारी	पटवारी
pataakshep	पताक्षेप	पटाक्षेप
patachep	पताचेप	पटाक्षेप
patakshep	पताक्षेप	पटाक्षेप
patiya	पटिया	पटिया
patiyaa	पटिया	पटिया
padaraunaa	पदाौौना	पडरौना
padrauna	पद्रौना	पडरौना
padega	पड़ेगा	पड़ेगा
padegaa	पड़ेगा	पड़ेगा
padha	पढ़ा	पढ़ा
padhaa	पढ़ा	पढ़ा
padhaataa	पढ़ाता	पढ़ाता
padhata	पढ़ता	पढ़ाता
patili	पतिली	पतीली
padamawati	पदममावती	पदमावती
padmavati	पद्मावती	पदमावती
padmawati	पद्मावती	पदमावती
padadhikari	पदाधिकारी	पदाधिकारी
panapnaa	पनपपना	पनपना
panpana	पनपनना	पनपना
panaamaa	पनामा	पनामा
panama	पनममा	पनामा
paneer	पनीीर	पनीर
pammi	पम्मी	पम्मी
pammu	पम्मू	पम्मी
pummi	पम्मी	पम्मी
pummy	पम्मी	पम्मी
pardesiyon	परददेशियों	परदेसियों
pardesi	परदेसी	परदेसी
parva	पर्वा	परवा
parvaa	पर्वा	परवा
parwa	परवााा	परवा
parwaa	परवाा	परवा
paraadheen	पराधीन	पराधीन
paraadhin	पराधीन	पराधीन
paradheen	पराधीन	पराधीन
paradhin	पराधीन	पराधीन
parikalpit	परिकल्पित	परिकल्पित
parimal	परिमल	परिमल
parishad	परिषद	परिषद
parishadiy	परििदादीय	परिषदीय
parishadiya	परिषदादीय	परिषदीय
parishadon	परिषदों	परिषदों
parikhaen	परिखखाएं	परीक्षाएं
parikshaayein	परीक्षाएं	परीक्षाएं
parikshaen	परीक्षाएं	परीक्षाएं
parosane	परोसने	परोसने
parosne	परोसने	परोसने
parda	परदा	पर्दा
pardaa	परदाा	पर्दा
purple	पर्पलल	पर्पल
palatne	पलाटने	पलटने
paltane	पलतनने	पलटने
palaari	पलारी	पलारी
palari	पालरीी	पलारी
pale	पाले	पले
palmonari	पा्मोनारी	पल्मोनरी
pulmonary	पु्मोनरी	पल्मोनरी
plus	प्लस	पल्स
pulse	पु्से	पल्स
pashtun	पष्टुन	पश्तून
pashtuun	पश्तुओ	पश्तून
pahan	पानन	पहन
pehan	पहनन	पहन
pahantaa	पहनता	पहनता
pahnata	पहनता	पहनता
pehnate	पहनते	पहनता
pahanate	पहनते	पहनते
pahante	पहनते	पहनते
pehnate	पहनते	पहनते
pahnaakar	पहनाकर	पहनाकर
pahnakar	पहनकर	पहनाकर
pehnakar	पहनार	पहनाकर
pahnaati	पहनाती	पहनाती
pahnati	पहनती	पहनाती
pehnati	पहनती	पहनाती
pahani	पहनीी	पहनी
pahni	पहनी	पहनी
pehni	पहनी	पहनी
pahno	पहनों	पहनो
pehno	पहनो	पहनो
pahla	पहला	पहला
pahlaa	पहला	पहला
pehla	पहला	पहला
paheliyaan	पहेलियां	पहेलियां
paheliyan	पहेलियां	पहेलियां
paheliyon	पहेलियों	पहेलियों
pide	पाइड	पाइड
pied	पायद	पाइड
pythagoras	पिथगोोरस	पाइथागोरस
pythogaras	पिथोगरास	पाइथागोरस
paakhandi	पाखंडी	पाखंडी
pakhandi	पाखंडी	पाखंडी
paathshaalaayein	पाठशालाएं	पाठशालाएं
pathshalayein	पाठशालाएं	पाठशालाएं
pathshalayen	पाठशालाएं	पाठशालाएं
paathyakram	पाठ्यक्रम	पाठ्यक्रम
pathyakram	पाठयक्रम	पाठ्यक्रम
pathykram	पाठ्यक्रम	पाठ्यक्रम
paathyakramon	पाठ्यक्रमों	पाठ्यक्रमों
pathyakramon	पाठ्यक्रमों	पाठ्यक्रमों
pathykramon	पाठ्यक्रमों	पाठ्यक्रमों
population	पॉपुलेशन	पापुलेशन
pailot	पैलोट	पायलट
pilot	पिलोट	पायलट
pailoton	पैलोटों	पायलटों
piloton	पिलोटों	पायलटों
paarampariktaa	पारंपरििकता	पारंपरिकता
paramparikata	परंंपारिकता	पारंपरिकता
paramparikta	परंंपारिकता	पारंपरिकता
parnel	पर्नेल	पार्नेल
parnell	पर्नेल	पार्नेल
parleron	पार्लरों	पार्लरों
parloron	परलोरों	पार्लरों
parlouron	परलोरों	पार्लरों
paarshad	पारशदद	पार्षद
parshad	पररददद	पार्षद
paarshadon	पार्ददों	पार्षदों
parshadon	पररददों	पार्षदों
parshdon	पररददों	पार्षदों
policy	पॉलिसी	पालिसी
pinta	पींटा	पिंटा
pintaa	पींता	पिंटा
piega	पीएगा	पिएगा
piyegaa	पिएेगा	पिएगा
pic	पिक	पिक
pick	पिक	पिक
pik	पीक	पिक
piki	पीकी	पिकी
piky	पिकी	पिकी
picture	पिक्चर	पिक्चर
pigmentation	पिग्मेंटेशन	पिगमेंटेशन
pigs	पिग्स	पिग्स
pichde	पिछड़े	पिछड़े
pichhade	पिछड़े	पिछड़े
pijja	पिजज़ा	पिज्जा
pizza	पिज्ज़ा	पिज्जा
pitaamaha	पितामह	पितामह
pitamah	पीतममह	पितामह
pipra	पिपरा	पिपरा
pipraa	पिपरा	पिपरा
pipli	पिपली	पिपली
pearson	पररसोन	पियरसन
pierson	पियर्सन	पियरसन
peary	पेरी	पियरी
piyari	पियरीी	पियरी
pisaai	पिसाई	पिसाई
pisai	पिसाई	पिसाई
pihaani	पिहानी	पिहानी
pihani	पिहनी	पिहानी
pib	पिब	पीआईबी
pr	प्र	पीआर
pml	पीममएल	पीएमएल
pmo	प्मो	पीएमओ
pmch	पीएचच	पीएमसीएच
psv	प्ससवी	पीएसवी
peaking	पीकिंग	पीकिंग
picking	पिकिंग	पीकिंग
peetne	पीटने	पीटने
pitne	पितने	पीटने
pedia	पेडिया	पीडिया
pidiya	पीड़िया	पीडिया
pidiyaa	पिड़िया	पीडिया
peelepan	पीलेपन	पीलेपन
pilepan	पिलेपन	पीलेपन
pv	प्वी	पीवी
pisa	पीसा	पीसा
putla	पुतला	पुतला
putlaa	पुतला	पुतला
putaliyaan	पुतलियां	पुतलियां
putliyan	पुटलियां	पुतलियां
putaliyon	पुतलियों	पुतलियों
putliyon	पुतलियों	पुतलियों
putali	पुतली	पुतली
putli	पुतली	पुतली
putale	पुतले	पुतले
putle	पुटल	पुतले
putin	पुटीन	पुतिन
putul	पुतुल	पुतुल
punargathan	पुनर्गठन	पुनर्गठन
puna	पुना	पुना
puraane	पुराने	पुराने
purane	पुराने	पुराने
puru	पुरु	पुरू
purjon	पुर्जों	पुर्जों
purzon	पुर्जों	पुर्जों
pulam	पुलम	पुलम
pushkin	पुश्कीन	पुश्किन
pushkarana	पुष्करण	पुष्करणा
pushkarna	पुष्करणण	पुष्करणा
pushkarnaa	पुष्करणा	पुष्करणा
pushp	पुष्प	पुष्प
pushpa	पुष्प	पुष्प
pushpa	पुष्प	पुष्पा
pushpaa	पुषपा	पुष्पा
pushpit	पुष्पित	पुष्पित
pushpon	पुषपों	पुष्पों
poonjikaran	पूंजीकरण	पूंजीकरण
punjikaran	पुंजीकरण	पूंजीकरण
poojaapaath	पूजापाठ	पूजापाठ
poojapath	पूजापठ	पूजापाठ
pujapath	पूजापथ	पूजापाठ
pooranpur	पूराणपुर	पूरनपुर
puranpur	पुराणपुर	पूरनपुर
purvaabhaas	पूर्वाभास	पूर्वाभास
purvaabhas	पूर्वाभास	पूर्वाभास
purvabhaas	पूर्वभभास	पूर्वाभास
purvabhas	पूर्वभभास	पूर्वाभास
pendulam	पेंडुलम	पेंडुलम
pendulum	पेंडुलुम	पेंडुलम
peg	पेग	पेग
pages	पेगेस	पेजेज
pajej	पजेज	पेजेज
pace	पेस	पेस
pes	पेस	पेस
pastry	पास्ट्री	पेस्ट्री
pangolin	पंंगोलीन	पैंगोलिन
pengolin	पेंगोलीन	पैंगोलिन
packard	पैकार्ड	पैकर्ड
package	पैकेज	पैकेज
packageon	पैकाजियन	पैकेजों
packagon	पैकागों	पैकेजों
packajon	पैकाजों	पैकेजों
paim	पैमम	पैम
pam	पाम	पैम
paratrooper	परत्रूपर	पैराट्रूपर
peratrupers	पेराटरपर्स	पैराट्रूपर
paranormal	परणोरमल	पैरानॉर्मल
peranormal	पररनोरमल	पैरानॉर्मल
paraffin	परफफीन	पैराफिन
parafin	परफफीन	पैराफिन
perafin	पेराफीन	पैराफिन
parabola	परबबोला	पैराबोला
perabola	पेराबोला	पैराबोला
polimer	पॉलिमर	पॉलिमर
polymer	पॉलीमर	पॉलिमर
polishing	पोलिशिंग	पॉलिशिंग
pokar	पोकरर	पोकर
poker	पोकर	पोकर
polish	पोलिश	पोलिश
poshit	पोशित	पोषित
posta	पोस्त	पोस्ता
pau	पाऊ	पौ
pyade	प्यादे	प्यादे
prakriya	प्रक्रिया	प्रक्रिया
prakshepak	प्रक्षेपक	प्रक्षेपक
pratigya	प्रतिज्ञा	प्रतिज्ञा
prtigyaa	प्रतिज्ञा	प्रतिज्ञा
pratibhutiyan	प्रतिभूतियां	प्रतिभूतियां
pratiyon	प्रतियों	प्रतियों
prativaad	प्रतिवाद	प्रतिवाद
prativad	प्रतिवाद	प्रतिवाद
prativadi	प्रतिवादी	प्रतिवादी
pratishat	प्रतिष्ट	प्रतिशत
praneet	प्रणीत	प्रनीत
pranit	प्राणत	प्रनीत
prapaat	प्रपात	प्रपात
prapat	प्रपपत	प्रपात
prapaaton	प्रपातों	प्रपातों
prapaton	प्रपातों	प्रपातों
prabodhini	प्रबोधिनी	प्रबोधिनी
prayaasrat	प्रयास्रत	प्रयासरत
prayasarat	प्रयासरत	प्रयासरत
pradarshan	प्रदर्शन	प्रर्दशन
prardashan	प्रर्दशशन	प्रर्दशन
pravati	प्रवती	प्रवत्ति
pravatti	प्रवटती	प्रवत्ति
prashaasanik	प्रशासननिक	प्रशासनिक
prashasanik	प्रशासानिक	प्रशासनिक
prashasnik	प्रशासननिक	प्रशासनिक
prashaasanon	प्रशासनों	प्रशासनों
prashansanon	प्रशंसनों	प्रशासनों
prashasanon	प्रशासनों	प्रशासनों
prashikshu	प्रशिक्षु	प्रशिक्षु
prastaavon	प्रस्तावों	प्रस्तावों
prastavon	प्रस्तावों	प्रस्तावों
prahlaad	प्रहलाद़	प्रहलाद
prahlad	प्राललाद	प्रहलाद
prahasan	प्रहासन	प्रहसन
prahsan	प्राससन	प्रहसन
prahaarak	प्रहारक	प्रहारक
praharak	प्रहारक	प्रहारक
prahad	प्रहाद	प्रह्लाद
prahlad	प्राललाद	प्रह्लाद
privacy	प्रिववीसी	प्राइवेसी
praakkathan	प्राक्ठन	प्राक्कथन
prakkathan	प्रक्ठन	प्राक्कथन
praan	प्राण	प्राण
pran	प्राण	प्राण
pranon	प्रणों	प्राणों
prathamik	प्रथथिक	प्राथमिक
prathmik	प्राथििक	प्राथमिक
praathmikata	प्राथमिकता	प्राथमिकता
prathmikta	प्राथििकता	प्राथमिकता
prathmiki	प्राथििकी	प्राथमिकी
pradhyapakon	प्राध्यापकों	प्राध्यापकों
prapt	प्रपप्त	प्राप्त
prapta	प्रपप्त	प्राप्त
prapti	प्रपपतत	प्राप्ती
praroop	प्ररूप	प्रारूप
prarup	प्ररूप	प्रारूप
priyamani	प्रियमानी	प्रियामणि
proof	प्रूफ	प्रूफ
pruf	प्रुफ	प्रूफ
prekshakon	प्रेक्षकों	प्रेक्षकों
prem	प्रेम	प्रेम
premlata	प्रेमलताा	प्रेमलता
prema	प्रेमा	प्रेमा
premi	प्रेमी	प्रेमी
profit	प्रोफिट	प्रॉफिट
processing	प्रोसेसिंंग	प्रॉसेसिंग
programers	प्रोग्रामर्स	प्रोग्रामर्स
programmers	प्रोग्राममर्स	प्रोग्रामर्स
programs	प्रोग्राम्स	प्रोग्रामर्स
proto	प्रोटो	प्रोटो
propellant	प्रॉपेललंट	प्रोपेलेंट
propellent	प्रॉपेलेंट	प्रोपेलेंट
praudh	प्रौढ़	प्रौढ
proud	प्राउड	प्रौढ
plan	प्लान	प्लेन
plane	प्लेन	प्लेन
fund	फंड	फंड
funda	फुंदा	फंडा
funding	फंडिंग	फंडिंग
fandon	फांडों	फंदों
fagua	फागुआ	फगुआ
fatane	फटनने	फटने
phatane	फटनने	फटने
phatne	फटनेे	फटने
fadfadata	फड़फड़ाता	फड़फड़ाता
phadphadata	फड़फड़़ताा	फड़फड़ाता
fatehgadh	फतेहगढ़	फतेहगढ़
fatehgarh	फतेहगढ़	फतेहगढ़
fabti	फबबती	फब्ती
phabti	फबबती	फब्ती
farse	फार्स	फरसे
pharase	फरासे	फरसे
pharse	फर्सस	फरसे
farheen	फरहीन	फरहीन
farhin	फरहीन	फरहीन
farth	फररथ	फर्थ
ferth	फर्थ	फर्थ
pharth	फर्थ	फर्थ
farmion	फरमियों	फर्मिऑन
fermion	फर्मियन	फर्मिऑन
firmian	फर्मियां	फर्मिऑन
farookhabad	फरूखाबड	फर्रुखाबाद
farrukhabad	फररुखाब	फर्रुखाबाद
farukhabad	फरुखाबड	फर्रुखाबाद
farookhnagar	फरूखनागर	फर्रूखनगर
farrukhnagar	फररुखागर	फर्रूखनगर
farukhnagar	फरुखनागर	फर्रूखनगर
falata	फलाता	फलता
falta	फलत्ाा	फलता
phalata	फलााा	फलता
falne	फलनने	फलने
phalne	फलने	फलने
falitarth	फलीतार्थ	फलितार्थ
phalitartha	फलीतार्थ	फलितार्थ
falibhoot	फलीभूत	फलीभूत
falibhut	फलीभूत	फलीभूत
phalibhoot	फलीभूत	फलीभूत
favvara	फवववराा	फव्वारा
fawaara	फवारा	फव्वारा
favvare	फवववारे	फव्वारे
fawaare	फवारे	फव्वारे
favvaron	फवववरों	फव्वारों
fawaaron	फवारों	फव्वारों
faisala	फैसलाा	फ़ैसला
faisla	फैैला	फ़ैसला
follow	फोलो	फ़ॉलो
faansi	फांसी	फांसी
fansi	फांसी	फांसी
fatama	फतमा	फातमा
fatma	फत्मा	फातमा
faaf	फाफ	फाफ
phaaph	फाफ	फाफ
farsi	फरासी	फारसी
forcee	फोरससी	फारसी
farm	फर्मम	फार्म
form	फॉर्म	फार्म
farmic	फार्मिक	फार्मिक
formic	फॉर्मिक	फार्मिक
formulae	फॉर्मुलाई	फार्मूले
formule	फॉर्मूल	फार्मूले
formuley	फॉर्मूली	फार्मूले
pharmacy	फर्मासी	फार्मेसी
pharma	फर्मा	फार्मों
pharmon	फर्मों	फार्मों
farms	फर्म्स	फार्म्स
finger	फांगर	फिंगर
fikra	फीकरा	फिक्र
physician	फिजिशियन	फिजिशियन
firti	फर्ती	फिरती
fisla	फिसला	फिसला
fislaa	फिसला	फिसला
feeder	फीदर	फीडर
fulaaye	फुलाय	फुलाए
fulae	फुलाई	फुलाए
fulay	फुलय	फुलाए
furti	फर्ती	फूर्ति
phurti	फूरती	फूर्ति
fus	फस	फूस
phoos	फूस	फूस
phus	फसस	फूस
feka	फेका	फेका
fefada	फेफड़ा	फेफड़ा
fefda	फेफड़ा	फेफड़ा
facial	फैशिय	फेशियल
fact	फैक्ट	फैक्ट
federal	फेडरल	फैडरल
failkar	फैलकर	फैलकर
failaaiye	फैलाइए	फैलाइए
failaea	फैलाया	फैलाइए
failaiya	फैलाया	फैलाइए
failaiye	फैलाइए	फैलाइए
failegi	फैलेगी	फैलेगी
font	फॉंटट	फॉन्ट
fogat	फोगत	फोगाट
phogat	फोगत	फोगाट
fod	फोड	फोड़
phod	फोड़	फोड़
foda	फोडा	फोड़ा
fodaa	फोडा	फोड़ा
phoda	फोडा	फोड़ा
fode	फोड़	फोड़े
phode	फोड़	फोड़े
fodo	फोडोो	फोड़ों
fodon	फोड़ों	फोड़ों
phodo	फोडोो	फोड़ों
fortis	फॉर्टिस	फोर्टिस
fusion	फूजन	फ्यूजन
fuji	फूजी	फ्यूजी
fyuji	फायौजी	फ्यूजी
francisca	फ्रांसिस्का	फ्रांसिस्का
franciska	फ्रांसिस्का	फ्रांसिस्का
fransiska	फ्रांसिस्का	फ्रांसिस्का
francisco	फ्रांसिस्को	फ्रांसिस्को
francisko	फ्रांसिस्को	फ्रांसिस्को
fransisko	फ्रांसिस्को	फ्रांसिस्को
fringe	फ्रिंग	फ्रिंज
friendship	फ्रींदशिप	फ्रेंडशिप
frost	फ्रॉस्ट	फ्रॉस्ट
flin	फ्लिन	फ्लिन
flynn	फ्लाइन	फ्लिन
flesh	फ्लेश	फ्लेश
bang	बैंग	बंग
bung	बंंग	बंग
bangbandhu	बंगबंध	बंगबंधु
bangbhang	बंंभांग	बंगभंग
bangash	बंगगशश	बंगश
bangsh	बांगशश	बंगश
bantane	बंटनने	बंटने
bantne	बंटटने	बंटने
bandhati	बंधधती	बंधती
bandhti	बाधधती	बंधती
bandhan	बंधन	बंधान
bandhuon	बंधुओं	बंधुओं
bamba	बांबा	बंबा
mumba	मूंबा	बंबा
bakaayon	बकायों	बकायों
bakayon	बकायों	बकायों
bakaul	बकौल	बकौल
bakoul	बककल	बकौल
baksa	बकसा	बक्सा
baksi	बकससी	बक्सी
bakse	बकसे	बक्से
bakhshane	बक्षणाे	बख्शने
bakhshne	बख्ष्ने	बख्शने
bagad	बागड़	बगड़
bagd	बागड	बगड़
bageechi	बगीची	बगीची
bagichi	बागची	बगीची
bachat	बचात	बचत
bachati	बचाती	बचती
bachti	बचतीी	बचती
bajana	बजनना	बजना
bajrangi	बजरंंगी	बजरंगी
bajaj	बजजजज	बजाज
batalvi	बतलवववी	बटालवी
badhachadhakar	बढ़ााधककर	बढ़ाचढ़ाकर
badata	बड़ता	बढ़ाता
badhaataa	बढ़ाता	बढ़ाता
badhata	बढ़ता	बढ़ाता
badhaati	बढ़ाती	बढ़ाती
badhati	बढ़ती	बढ़ाती
badhayi	बधधाई	बढ़ायी
badhav	बढ़ाव	बढ़ाव
badhotari	बढ़ोततरी	बढ़ोतरी
badhotri	बाधोत्री	बढ़ोतरी
batlaae	बतलाई	बतलाए
batlaaye	बतलाए	बतलाए
batlae	बतलाई	बतलाए
batlaye	बतलाय	बतलाए
batlaakar	बतलाकर	बतलाकर
batlakar	बतलाकर	बतलाकर
badlapur	बदलापुर	बदलापुर
badali	बदली	बदली
badli	बदली	बदली
badam	बददाम	बदाम
banva	बनवा	बनवा
banvaa	बनवा	बनवा
banaam	बनाम	बनाम
banam	बन्म	बनाम
bnaam	बनाम	बनाम
baniya	बनिया	बनिया
banu	बानू	बनू
barpaayaa	बरपाया	बरपाया
barpaya	बरपाया	बरपाया
barsa	बररससा	बरसा
barsaata	बरसाता	बरसाता
barsaataa	बरसाता	बरसाता
barsata	बरससता	बरसाता
barhad	बढ़हड़	बरहद
baraat	बरातत	बरात
barat	बराात	बरात
braat	ब्रात	बरात
baraamad	बरामद	बरामद
baramad	बरामद	बरामद
bramad	ब्रमा़	बरामद
baramade	बरामद	बरामदे
baramde	बरामडे	बरामदे
bare	बारे	बरे
birth	बर्थ	बर्थ
baljeet	बलजीत	बलजीत
baljit	बलजजित	बलजीत
ballabh	बल्लभ	बल्लभ
balla	बल्ला	बल्ला
balli	बल्ली	बल्ली
basava	बसवाा	बसावा
bastiyon	बस्तियों	बस्तियों
bahroopiya	बहरूपीय	बहरूपिया
bahrupiya	बहरूपीय	बहरूपिया
bahamaas	बहमासस	बहामास
bahamas	बहमासस	बहामास
bahaav	बहाव	बहाव
bahav	बाहव	बहाव
bhav	भाव	बहाव
bahavalpur	बहावलपुर	बहावलपुर
bahawalpur	बहावलपुर	बहावलपुर
bahuchara	बहुचारा	बहुचरा
banthia	बंथिया	बांठिया
banthiya	बंथिया	बांठिया
bandhate	बंधधते	बांधते
bandhte	बांधते	बांधते
banbi	बंंबी	बांबी
bombi	बोम्बी	बांबी
bounceron	बाउससरों	बाउंसरों
bowling	बोलिंग	बाउलिंग
baku	बाकू	बाकू
bakuu	बाकू	बाकू
baag	बाग	बाग
bag	बैग	बाग
bagh	बाघ	बाग
bagabani	बागबनीी	बागबानी
bagbani	बागबानी	बागबानी
bagali	बगली	बागली
bagli	बगली	बागली
baagiyon	बागियों	बागियों
bagiyon	बगगयोों	बागियों
baago	बागो	बागो
bago	बैगो	बागो
baji	बजजी	बाज़ी
bazi	बजजी	बाज़ी
bajaru	बाजरू	बाजारू
bazaru	बजजररू	बाजारू
bajuon	बाजुओं	बाजुओं
badh	बढ़	बाध
badha	बढ़ा	बाधा
baadhaaon	बाधाओं	बाधाओं
baadhaon	बाधाओं	बाधाओं
badhaaon	बढधाओं	बाधाओं
badhaon	बढ़ाओं	बाधाओं
baadhit	बाधित	बाधित
badhit	बढ़ित	बाधित
baani	बानी	बानी
bani	बननी	बानी
baapa	बापा	बापा
baapaa	बापा	बापा
bapa	बापा	बापा
bapaa	बापा	बापा
baabat	बाबत	बाबत
babat	बबतत	बाबत
babt	बबब्ट	बाबत
bayern	बेयर्न	बायर्न
byrun	बयरून	बायर्न
barah	बााह	बारह
baarahamaasee	बारहमासी	बारहमासी
barahamasi	बारहमासी	बारहमासी
barahmasi	बारहमासी	बारहमासी
barahsinga	बारहसिंगा	बारहसिंगा
barasingha	बारसिंघ	बारहसिंगा
bala	बलला	बाला
baalti	बालती	बाल्टी
balti	बलतीी	बाल्टी
balty	बाल्टी	बाल्टी
baldvin	बाल्वीीन	बाल्डविन
baldwin	बाल्ववीन	बाल्डविन
bavaji	बावजीी	बावजी
bavji	बावजी	बावजी
baawaraa	बावरा	बावरा
bavra	बावरा	बावरा
bawara	बावराा	बावरा
baahulya	बाहुल्य	बाहुल्य
bahuly	बहुल्य	बाहुल्य
bahulya	बहुल्य	बाहुल्य
box	बॉक्स	बाॅक्स
bikherati	बिखेरती	बिखेरती
bikherti	बिखरती	बिखेरती
biggest	बागगेस्ट	बिगेस्ट
bichhua	बिछुआ	बिछुआ
bichhuaa	बिछुआ	बिछुआ
biji	बीजी	बिजी
busy	बस्य	बिजी
buzy	बुजी	बिजी
bipin	बाइपिन	बिपिन
bilae	बिलाई	बिलाई
bilai	बिलाई	बिलाई
billa	बिलाला	बिल्ला
billaa	बिल्ला	बिल्ला
bilhaur	बिलहहौर	बिल्हौर
bisva	बिस्व	बिस्वा
biswa	बिस्वा	बिस्वा
bag	बैग	बीएजी
bikaner	बिकानर	बीकानेर
bikaneri	बिकनेरी	बीकानेरी
bk	बकक	बीके
beejak	बीजक	बीजक
bijak	बिजक	बीजक
beef	बीफ	बीफ
beem	बीम	बीम
bim	बिम	बीम
beemon	बीमों	बीमों
bimon	बीमों	बीमों
beerganj	बीरगंज	बीरगंज
birganj	बीरगंज	बीरगंज
beesavaan	बीसवान	बीसवां
bisavan	बीसवान	बीसवां
bisawan	बीसवान	बीसवां
beast	बीसस्ट	बीस्ट
budvig	बुडववग	बुडविग
budwig	बुडविग	बुडविग
bull	बुल	बुल
bulaao	बुलाओ	बुलाओ
bulao	बुलाओ	बुलाओ
bule	बुले	बुले
bulletin	बुलेटीन	बुलेटिन
brijesh	ब्रजेश	बृजेश
benvar	बेनवरर	बेंवर
benwar	बेनवार	बेंवर
beaulad	बीउौल	बेऔलाद
bekaaboo	बेकाबू	बेकाबू
bekabu	बेकाबू	बेकाबू
bechakar	बेचाकर	बेचकर
bechkar	बेचकर	बेचकर
bechate	बेचते	बेचते
bechte	बेचते	बेचते
bediyan	बेड़ियां	बेड़ियां
bethanal	बेथननल	बेथनल
bethnal	बेथनाल	बेथनल
benis	बेनिस	बेनिस
belacha	बेलचा	बेलचा
belcha	बेल्चा	बेलचा
belinda	बेलिंदा	बेलिंडा
bevkufana	बेवकूफना	बेवकूफाना
bewakoofaanaa	बेवकूफाना	बेवकूफाना
bewkufana	बेवुफनना	बेवकूफाना
besahaaraa	बेसहरा	बेसहारा
besahara	बेसहरा	बेसहारा
basin	बसीन	बेसिन
besin	बेजिन	बेसिन
basil	बससल	बेसिल
besil	बेसिल	बेसिल
bandage	बंंडे	बैंडेज
bandej	बंदेज	बैंडेज
baithantey	बैठांते	बैठते
baithate	बैठते	बैठते
baitool	बैटूल	बैतूल
baitul	बैटुल	बैतूल
betul	बेटुल	बैतूल
baini	बैनी	बैनी
beni	बेनी	बैनी
bairakpur	बैरकपुर	बैरकपुर
barrackpore	बैराक्पोर	बैरकपुर
baila	बैलाा	बैला
bella	बेल्ला	बैला
ballistic	बललिस्टिक	बैलिस्टिक
bells	बेल्स	बैल्स
bostan	बोस्तान	बॉस्टन
bosten	बोस्टन	बॉस्टन
boston	बोस्टन	बॉस्टन
bokaro	बोकरोो	बोकारो
bodara	बोडारा	बोदरा
bodra	बोदरर	बोदरा
bodraa	बोदरा	बोदरा
bona	बोना	बोना
borkar	बोरकर	बोरकर
borivali	बोरीवाली	बोरीवली
boriwali	बोरीवाली	बोरीवली
born	बॉर्न	बोर्न
bolane	बोलने	बोलने
boliae	बोलियाई	बोलिए
boliy	बोलीय	बोलिए
boliye	बोलिय	बोलिए
bosaan	बोसान	बोसान
bosan	बोसनन	बोसान
bauni	बौनी	बौनी
bouni	बौनी	बौनी
byaawa	ब्यावा	ब्यावर
byavar	ब्यावर	ब्यावर
brajesh	ब्रजेश	ब्रजेश
brijesh	ब्रजेश	ब्रजेश
brahmalin	ब्रह्मालीन	ब्रह्मलीन
brahmleen	ब्रह्मलीन	ब्रह्मलीन
brahmlin	ब्राहमललनन	ब्रह्मलीन
bravo	ब्रववो	ब्रावो
brigatn	ब्रिगटन	ब्रिगटन
brighton	ब्राइटन	ब्रिगटन
brigton	ब्रिगटन	ब्रिगटन
brigadier	ब्रिगडडीर	ब्रिगेडियर
britain	ब्रिटाइन	ब्रिटेन
breed	ब्रीड	ब्रीद
brock	ब्रॉक	ब्रोक
brok	ब्रॉक	ब्रोक
broke	ब्रॉक	ब्रोक
brocken	ब्रॉकनन	ब्रोकन
broken	ब्रोकनन	ब्रोकन
blosam	ब्लोसम	ब्लॉसम
blossom	ब्लॉसोम	ब्लॉसम
bhagaane	भगाने	भगाने
bhagane	भागने	भगाने
bhadakaaya	भड़काया	भड़काया
bhadakaya	भड़काया	भड़काया
bhadkaayaa	भड़काया	भड़काया
bhadkaya	भड़काया	भड़काया
bharakaaya	भड़काया	भड़काया
bharakaya	भड़काया	भड़काया
bhabhoot	भभूूत	भभूत
bhabhut	भभूूत	भभूत
bhay	भयय	भय
bhaya	भयया	भय
bhayo	भययो	भयो
bharatanatyam	भारतनाा््यम	भरतनाट्यम्
bharatnatyam	भारतनात्यम	भरतनाट्यम्
bhartnatyam	भर्तनात्यम	भरतनाट्यम्
bharate	भररते	भरते
bharte	भरते	भरते
bharani	भरणी	भरनी
bharni	भरणी	भरनी
bharane	भरनन	भरने
bharne	भरने	भरने
bhara	भररा	भरा
bhavishya	भविष्य	भविष्य
bhaate	भाते	भाते
bhate	भाते	भाते
bhanu	भानु	भानू
bhabar	भाबर	भाबर
bhareeye	भररीय	भारीय
bhariy	भररयय	भारीय
bhavanaon	भावनाओं	भावनाओं
bhavnaon	भावनाओं	भावनाओं
bhaskar	भस्कर	भास्कर
bheed	भीड़	भीड़
bheera	भीरा	भीरा
bhira	भिरा	भीरा
bheesham	भीषम	भीष्म
bhisham	भिश्म	भीष्म
bhishm	भिश्म	भीष्म
bhugat	भूगत	भुगत
bhugata	भुगता	भुगता
bhugta	भूगता	भुगता
bhutto	भू्टो	भुट्टो
bhumi	भूमी	भुमि
bhurbhura	भूरभूरा	भुरभुरा
bhookh	भूख	भूख
bhukh	भूख	भूख
bhookhi	भूखी	भूखी
bhukhi	भूखी	भूखी
bhoogol	भूगोल	भूगोल
bhugol	भूगोल	भूगोल
bhootal	भूतल	भूतल
bhutal	भूतल	भूतल
bhoopsingh	भूपसिंघ	भूपसिंह
bhupsingh	भूपसिंघ	भूपसिंह
bhumi	भूमी	भूमी
bhumika	भूमिका	भूमी
bhulata	भुलताा	भूलता
bhulataa	भुलता	भूलता
bhulta	भुलता	भूलता
bhula	भुला	भूला
bhulaa	भुला	भूला
bhooli	भूली	भूली
bhuli	भूली	भूली
bhulo	भूलो	भूलो
bhulon	भूलों	भूलों
bhusi	भूसी	भूसी
bhooswaami	भूस्वामी	भूस्वामी
bhusvami	भूस्वामी	भूस्वामी
bhuswami	भूस्वामी	भूस्वामी
bhengapan	भेंगापन	भेंगापन
bhairavnath	भैरावनाथ	भैरवनाथ
bhairo	भैरो	भैरो
bhogatey	भोगते	भोगते
bhogte	भोगते	भोगते
bhola	भोला	भोला
bholi	भोली	भोली
bholu	भोलू	भोलू
bhaunho	भौन्हों	भौंहों
bhaunhon	भौन्हों	भौंहों
bhoonhon	भून्हों	भौंहों
bhraant	भ्रांत	भ्रांत
bhrant	भ्रांत	भ्रांत
brant	ब्रांट	भ्रांत
bhraanti	भ्राती	भ्रांति
bhranti	भ्राती	भ्रांति
branti	ब्रांटी	भ्रांति
bhraantiyan	भ्रातियां	भ्रांतियां
bhrantiyan	भ्रत्तियां	भ्रांतियां
bhraantiyon	भ्रातियों	भ्रांतियों
bhrantiyon	भ्ाततियों	भ्रांतियों
mangesh	मंगेश	मंगेश
manch	मांच	मंच
manchit	मांछित	मंचित
mancheeye	मंंचीय	मंचीय
manchiy	मांचीय	मंचीय
manchiya	मांचिया	मंचीय
manchon	मांचों	मंचों
manjil	मंजजिल	मंजिल
manzil	मंंजिल	मंजिल
manjila	मंजीला	मंजिला
manzila	मंंजीला	मंजिला
manjilein	मंजीललें	मंजिलें
manjilen	मांजीलें	मंजिलें
manzilein	मंंजीलें	मंजिलें
manto	मंटो	मंटो
mantriyon	मंत्रियों	मंत्रियों
makrani	मकरानी	मकरानी
maksad	मकसाद	मक्सद
makhdumpur	मखदुमपुर	मखदुमपुर
machaaye	मचाय	मचाए
machae	मचाई	मचाए
machaye	मचाय	मचाए
machaanon	मचानों	मचानों
machanno	मशन्नो	मचानों
machano	मचानो	मचानों
machanon	मचानों	मचानों
madaura	मदौरा	मढ़ौरा
madhuara	मधुररा	मढ़ौरा
madhura	मधुरा	मढ़ौरा
manipal	मनिपाल	मणिपाल
matpatron	मततपत्रों	मतपत्रों
matthe	मट्ठे	मत्थे
matsyavatar	मत्स्यावतर	मत्स्यावतार
matsyavtar	मत्स्यावतर	मत्स्यावतार
masyendranath	मासययंद्रनाथ	मत्स्येंद्रनाथ
matsyendranath	मत्स्यंद्रनाथ	मत्स्येंद्रनाथ
madhupur	मधुपुर	मधुपुर
manmarji	मनममारजी	मनमर्जी
manae	मनाई	मनाए
manaye	मनाय	मनाए
mnaey	मनाए	मनाए
mam	माम	मम
mum	ममम	मम
maryokar	मररयोोकार	मयोर्का
mayorka	मययर्का	मयोर्का
mayorkaa	मयोर्का	मयोर्का
mardaani	मर्दानी	मरदानी
mardani	मर्दानी	मरदानी
marmar	मररमररर	मरमर
murmur	मुरमूर	मरमर
maratha	मररठा	मराठा
marathi	मररथी	मराठी
marji	मर्जी	मर्जी
mardanagi	मर्दनागी	मर्दानगी
mardangi	मर्दंगी	मर्दानगी
mardo	मर्डोो	मर्दों
mardon	मर्डों	मर्दों
maryaadaa	मर्यादा	मर्यादा
maryada	मर्यादाा	मर्यादा
maryaadaaon	मर्यादाओं	मर्यादाओं
maryadaon	मर्यदााओं	मर्यादाओं
malaga	मालााा	मलागा
malaar	मालार	मलार
malar	मालार	मलार
mashrak	मशर्क	मशरक
masaaledaar	मसालेदार	मसालेदार
masaledaar	मसालेदार	मसालेदार
masaledar	मसललेदार	मसालेदार
masoor	मसूर	मसूर
masur	मसूर	मसूर
masse	मससे	मस्से
mahakane	महककने	महकने
mahakne	महकने	महकने
mahkane	महकाने	महकने
mehkane	मेहकने	महकने
mahalon	महलों	महलों
mahlon	महलों	महलों
mahagranth	महाग्रां	महाग्रंथ
mhagranth	महाग्रां	महाग्रंथ
mahajan	महाजन	महाजन
mhajan	महाजन	महाजन
mahathir	महािर	महाथिर
mhathir	महािर	महाथिर
mahanatam	महानतम	महानतम
mahantam	महानतम	महानतम
mhantam	महानतम	महानतम
mahanideshak	महानीदेश्क	महानिदेशक
mahanirdeshak	महानिर्देशक	महानिदेशक
mhanideshak	महानिदेशक	महानिदेशक
mahapauron	महापौरों	महापौरों
mhapauron	महापौरों	महापौरों
mahapran	महाप्रण	महाप्राण
mhapran	महाप्रण	महाप्राण
mahamantr	महामंत्र	महामंत्र
mahamantra	महामंत्र	महामंत्र
mhamantra	महामंत्र	महामंत्र
maharaja	महररजज	महाराजा
mahavigyan	महाविज्ञान	महाविज्ञान
mhavidyan	महाविद्यान	महाविज्ञान
mahavidya	महाविद्य	महाविद्या
mhavidya	महाविद्य	महाविद्या
mahavishnu	महाविष्णु	महाविष्णु
mahasingh	महासिंह	महासिंह
mahasinh	महासिंह	महासिंह
mahipal	महिपाल	महिपाल
mahin	महीन	महीन
mahinon	महिनों	महीनों
maang	मांग	मांग
mang	मांग	मांग
mangani	मंगानी	मांगनी
mangni	मंगगनी	मांगनी
maanga	मांगा	मांगा
manga	मंगा	मांगा
maangi	मांगी	मांगी
mangi	मंगी	मांगी
maange	मांगे	मांगे
mange	मंंे	मांगे
mango	मंगोो	मांगो
maori	माओरी	माओरी
maajin	माजीन	माजिन
majin	मजीन	माजिन
mathe	मठ्	माथे
mathey	मा्	माथे
maap	माप	माप
map	मैप	माप
mop	मोप	माप
mamooli	ममूली	मामूली
mamuli	मामूली	मामूली
mame	मेम	मामे
maarvaad	मार्वाद	मारवाड़
marvad	मारववाद	मारवाड़
marwar	मारववर	मारवाड़
maariya	मारिया	मारिया
mariya	मररिया	मारिया
maariyo	मारियो	मारियो
mario	मैरियो	मारियो
mariyo	मररियो	मारियो
martha	मार्थ	मार्था
maalish	मालीश	मालिश
malish	मालिश	मालिश
mave	माव	मावे
mavey	मावे	मावे
maas	मास	मास
mas	मास	मास
mass	मास	मास
maason	मासों	मासों
mason	मसों	मासों
mitaao	मिताओ	मिटाओ
mitao	मिताओ	मिटाओ
mithaai	मिठाई	मिठाई
mithai	मिठाई	मिठाई
media	मेडिया	मिडिया
mithila	मिथिला	मिथिला
mithilanchal	मिथिलांचल	मिथिलांचल
mithya	मिथ्या	मिथ्या
mimicry	मामिक्कीरी	मिमिक्री
milkiyat	मिलकियत	मिल्कियत
misha	मिशा	मिशा
mungeri	मूंगेरी	मुंगेरी
mundva	मुंडवा	मुंडवा
mundwa	मुंडवा	मुंडवा
munshiganj	मुंशीगंज	मुंशीगंज
mukarte	मुकर्ते	मुकरते
mukartey	मुकर्ते	मुकरते
mukhopadhyaya	मुखोपाध्याय	मुखोपाध्याय
mukhyopadhyaay	मुख्योपाध्याय	मुखोपाध्याय
mukhyamantri	मुख्यमंत्री	मुख्यमंत्री
munaf	मुनफफ	मुनाफ
munafa	मुनफाा	मुनाफा
munnu	मुन्नु	मुन्नू
mufalisi	मुफललसी	मुफलिसी
muflisi	मुफ्लीसी	मुफलिसी
mubarakpur	मुबराकपुर	मुबारकपुर
mubarkpur	मुबरककपुर	मुबारकपुर
murjha	मूरझा	मुर्झा
multae	मुलताई	मुल्ताई
multai	मुलताई	मुल्ताई
mushahid	मुशाहिद	मुशाहिद
muhavare	मुहावरे	मुहावरे
muhavre	मुहावरे	मुहावरे
mooth	मूठ	मूठ
muth	मूथ	मूठ
mood	मूद	मूड
mud	मुद़	मूड
moodi	मूदी	मूडी
moody	मूडी	मूडी
mool	मूल	मूल
mul	मूल	मूल
moolchand	मूलचंद	मूलचंद
mulchand	मूलचंद	मूलचंद
moolar	मूलर	मूलर
mular	मूलरर	मूलर
muller	मुलूलर	मूलर
moolon	मूलों	मूलों
mulon	मूलों	मूलों
maxico	मैक्सिको	मेक्सिको
mexico	मैक्सिको	मेक्सिको
mega	मेगा	मेगा
megapixal	मेगापिक्स	मेगापिक्सल
megapixel	मेगपििक्स	मेगापिक्सल
mejbaan	मेजबान	मेजबान
mejban	मेजबान	मेजबान
mezbaan	मेजबान	मेजबान
mejabani	मेजबानी	मेजबानी
mejbaani	मेजबानी	मेजबानी
mejbani	मेजबानी	मेजबानी
mezabani	मेजबानी	मेजबानी
mejbaan	मेजबान	मेज़बान
mejban	मेजबान	मेज़बान
mezbaan	मेजबान	मेज़बान
mejbaani	मेजबानी	मेज़बानी
mejbani	मेजबानी	मेज़बानी
mezbaani	मेजबानी	मेज़बानी
mate	मैट	मेट
met	मेट	मेट
mates	मैट्स	मेट्स
medical	मेडिकल	मेडीकल
methanol	मीथनॉल	मेथेनॉल
menu	मेनू	मेनू
mem	मेम	मेम
melaghaat	मेलाघाट	मेलघाट
melghat	मेलघटट	मेलघाट
melaanin	मेलानिन	मेलानिन
melanin	मेलानिन	मेलानिन
melaani	मेलानी	मेलानी
melani	मेलनी	मेलानी
maheman	महहमान	मेहमान
mehamaan	मेहमान	मेहमान
mehaman	मेहमान	मेहमान
mehmaan	मेहमान	मेहमान
mehman	मेहमान	मेहमान
meharaam	मेहराम	मेहराम
mehram	मेहराम	मेहराम
macbook	मैकबूक	मैकबुक
matix	मैटिक्स्स	मैट्रिक्स
matrix	माट्रिक्स	मैट्रिक्स
mad	माद	मैड
made	मेड	मैड
maid	मैद	मैड
maddy	मद्ड	मैडी
maidi	मैडी	मैडी
main	मैन	मैन
man	मनन	मैन
men	मेन	मैन
mainan	मैननन	मैनन
menon	मेनों	मैनन
manner	मनननर	मैनर
maina	मैना	मैना
maine	मैने	मैने
marrej	मररेज	मैरेज
marriage	मैरिज	मैरेज
merraige	मेरेज	मैरेज
maisachusets	मैसाचुसेट्स	मैसाचुसेट्स
massachusetts	मेसाचुसेट्स	मैसाचुसेट्स
maisor	मैइसर	मैसोर
maisore	मैइसरर	मैसोर
mysore	मिसूर	मैसोर
mod	मोड़	मॉड
mode	मोड़	मॉड
modern	मॉडर्न	मॉडर्न
module	मोडुले	मॉड्यूल
modules	मॉडुल्स	मॉड्यूल्स
modyuls	मॉडययू्स	मॉड्यूल्स
mauritious	मॉरीशसस	मॉरिशस
mauritius	मॉरीशस	मॉरिशस
mogali	मोगली	मोगली
mowgli	मौउगली	मोगली
motive	मोटिव	मोटिव
mol	मोल	मोल
mold	मॉल्ड	मोल्ड
moshe	मोशे	मोशे
mosad	मोसदद	मोसाद
mohana	मोहना	मोहाना
mohani	मोहनी	मोहानी
mohini	मोहिनी	मोहिनी
mohim	मोहिम	मोहिम
maukon	मौकों	मौकों
mauma	मौमा	मौमा
maurya	मौर्य	मौर्या
morya	मोर्य	मौर्या
maurya	मौर्य	मौर्यों
mauryon	मौर्यों	मौर्यों
moryon	मोरियों	मौर्यों
maulaviyon	मौलावियों	मौलवियों
maulvidon	मौलविदों	मौलवियों
maulviyon	मौलवियों	मौलवियों
maule	मौले	मौले
mauley	मौले	मौले
mausa	मौसा	मौसा
yatn	यत्न	यत्न
yatna	यानना	यत्न
yada	यादा	यदा
yda	यादा	यदा
yaduvansh	याुवंश	यदुवंश
yaduwansh	याुवंश	यदुवंश
jerusalem	जेरूसलेम	यरूशलेम
yarooshaleim	यररूशलेम	यरूशलेम
yarushalem	यररशशलमम	यरूशलेम
yashpaal	याषपाल	यशपाल
yashpal	याष्पल	यशपाल
yaatna	याटना	यातना
yatna	यानना	यातना
yaatanaon	याटनाओं	यातनाओं
yatnaon	यतनाओं	यातनाओं
yarayan	यारायन	यात्राएं
yatraein	यात्राएन	यात्राएं
yatraen	यात्राएं	यात्राएं
yaariyan	यारियां	यारियां
yariyan	यारियन	यारियां
yaari	यारी	यारी
yari	यार	यारी
yugam	युगाम	युग्म
yugm	युग्म	युग्म
yuddhrat	युद्धरत	युद्धरत
yudhrat	युद्धरत	युद्धरत
ukrainian	उकक्रेनिया	यूक्रेनियन
ukranian	उक्राणियां	यूक्रेनियन
jerusalem	जेरूसलेम	येरुशलम
yorker	यॉर्कर	यॉर्कर
yojanaein	योजनाएं	योजनाएं
yojanaen	योजनाएं	योजनाएं
yojanaye	योजनाय	योजनाएं
rangate	रंगटे	रंगते
rangte	रंगते	रंगते
rangkata	रंगकता	रंजकता
ranjkatha	रंजकथा	रंजकता
ranjkta	रंजकता	रंजकता
raees	राईस	रईस
rais	रायस	रईस
raktaabh	रक्ताभ	रक्ताभ
raktabh	रक्तभ	रक्ताभ
rakhna	रखना	रखना
raghupati	रघुपति	रघुपति
raghuram	रघुराम	रघुराम
registerd	रेिस्टर्ड	रजिस्टर्ड
registered	रेजस्टरेड	रजिस्टर्ड
ratanpur	रतनपपुर	रतनपुर
runners	रनर्स	रनर्स
rayan	रायन	रयान
ryan	रययान	रयान
ralhan	रल्हन	रल्हन
ravish	रविष	रविश
ravael	रवालल	रवैल
ravel	रवेल	रवैल
rawail	रवैल	रवैल
rasad	रसा़	रसद
rasaayanik	रसायनिक	रसायनिक
rasaayanika	रसायनिका	रसायनिक
rasayanika	रसायनिका	रसायनिक
rasyanik	रास्यानिक	रसायनिक
rasaayanon	रसायनों	रसायनों
rasayanon	रसायनों	रसायनों
rahamat	रहमत	रहमत
rahmat	रहमत	रहमत
rhamat	रहमत	रहमत
rahenge	रहेंगे	रहेंगे
rahegi	रहेगी	रहेगी
rounder	रांडर	राउंडर
raak	राक	राक
rak	रकक	राक
raakhe	राखे	राखे
rakhe	रखे	राखे
raagon	रागों	रागों
ragon	रगोन	रागों
raghavan	रघाानन	राघवन
raaj	राज़	राज
raj	राज	राज
rajkot	राजकोट	राजकोट
rajtantra	राजतंत्र	राजतंत्र
raajneetikaran	राजनीतीकरण	राजनीतीकरण
rajneetikaran	राजनीतीकरण	राजनीतीकरण
rajnitikaran	राजनीतीकरण	राजनीतीकरण
rajma	राजमा	राजमां
rajman	राजमान	राजमां
raajasva	राजस्व	राजस्व
rajasva	राजस्व	राजस्व
raaji	राजी	राजी
raji	राजी	राजी
rajinaama	राजीनामा	राजीनामा
rajinama	राजीनामा	राजीनामा
raajon	राजों	राजों
rajon	रजजों	राजों
rana	राना	राणा
raatrichar	रात्रिचार	रात्रिचर
ratrichar	रत्रिचार	रात्रिचर
raadhe	राधे	राधे
radhe	राधे	राधे
ranapur	रणनपुर	रानापुर
rabin	रबीन	राबिन
robin	रोबिन	राबिन
rabha	रभा	राभा
ramkot	रामकोट	रामकोट
ramkote	रामकोटे	रामकोट
ramtek	रामटेक	रामटेक
rampur	रामपुर	रामपुर
rambharose	रामभरों	रामभरोसे
rambharosey	रामभरोोी	रामभरोसे
ramraj	रामराज	रामराज
raalod	रालोड़	रालोद
ralaud	रलाौद	रालोद
ralod	रालोड़	रालोद
ravaley	रावले	रावले
ravle	रावले	रावले
rasayanik	रसायनिक	रासायनिक
racreation	रैक्रीएशन	रिक्रिएशन
recreation	रिक्रेशेशन	रिक्रिएशन
rig	रिग	रिग
riggs	रिग्स	रिग्स
rigs	रिग्स	रिग्स
richual	रिचुआल	रिचुअल
ritual	रायुुल	रिचुअल
reduction	रेडुक्शन	रिडक्शन
ripan	रिपन	रिपन
ripon	रिपों	रिपन
ria	रिया	रिया
riya	रिया	रिया
rishte	रिश्ते	रिश्ते
rishtey	रिश्ते	रिश्ते
risane	रिसने	रिसने
risaney	रिसने	रिसने
risne	रिसने	रिसने
rihana	रिाना	रिहाना
rihanna	रिन्ना	रिहाना
regal	रेगल	रीगल
rigal	रिगल	रीगल
reasonal	रिजसनल	रीजनल
regional	रेजियल	रीजनल
retreate	रिट्रेटट	रीट्वीट
retweet	रितवीत	रीट्वीट
reeta	रीता	रीता
rita	रीता	रीता
rukate	रुकते	रुकते
rukte	रुकते	रुकते
ruktey	रुकते	रुकते
rugan	रूगन	रुग्ण
rugna	रूग्ण	रुग्ण
ruganta	रुगातता	रुग्णता
rugnata	रूग्नता	रुग्णता
rojvelt	रोजवेलट	रुजवेल्ट
roojwelt	रूज़वेल्ट	रुजवेल्ट
roosevelt	रूज़वललट	रुजवेल्ट
rodolph	रोडोल्फ	रुडोल्फ
rudolf	रूडोल्फ	रुडोल्फ
rudolph	रूडोल्फ	रुडोल्फ
roopesh	रूपेश	रुपेश
rupesh	रुपेश	रुपेश
ruby	रूबी	रुबी
roomani	रूमान	रुमानी
rumani	रूमानी	रुमानी
rukavaton	रुकावटों	रूकावटों
root	रुट	रूट
route	राउट	रूट
rooting	रुटिंग	रूटिंग
routine	राउटीन	रूटिंग
routing	राउटिंग	रूटिंग
roots	रुट्स	रूट्स
routes	राउटस	रूट्स
roopak	रुपक	रूपक
rupak	रुपक	रूपक
roopi	रुपी	रूपी
rupi	रुपी	रूपी
rantle	रांटल	रेंटल
rental	रेंटल	रेंटल
registan	रेजस्तान	रेगिस्तान
registani	रेजस्तानी	रेगिस्तानी
reja	रेजा	रेजा
reza	रेजा	रेजा
rate	राट	रेट
rate	राट	रेत
ret	रेट	रेत
refaeli	रिफाइली	रेफेली
refeli	रेफेी	रेफेली
reshe	रेशे	रेशे
reshey	रेशे	रेशे
race	रेस	रेस
rese	रेज	रेस
racer	रेसर	रेसर
recer	रिसर	रेसर
racing	रेसिंग	रेसिंग
reson	रेसों	रेसों
rehaana	रहाना	रेहाना
rehana	रहना	रेहाना
racketeer	राकिटीर	रैकेटियर
racketier	राकेटियर	रैकेटियर
rectare	रेक्टेरर	रैकेटियर
radical	राडिकल	रैडिकल
raidical	राइडिकल	रैडिकल
raith	रैठ	रैथ
rapping	रैपिंग	रैपिंग
wrapping	रापिंंग	रैपिंग
robertsan	रोबर्ट्सन	रॉबर्टसन
robertson	रॉबर्टनस	रॉबर्टसन
robinson	रॉबिंसन	रॉबिंसन
royals	रोयल्स	रॉयल्स
rojlin	रोजलीन	रोजलिन
rozlyn	रोजलीन	रोजलिन
rotation	रोटेशन	रोटेशन
rodrigo	रोड्रगों	रोड्रिगो
ronaldo	रोनालडोो	रोनाल्डो
ronit	रोनीट	रोनित
roni	रोनी	रोनी
ropane	रोपने	रोपने
ropaney	रोपने	रोपने
ropne	रोपने	रोपने
robin	रोबिन	रोबिन
roya	रोया	रोया
rollers	रॉलर्स	रोलर्स
rovan	रोवान	रोवन
rowan	रोवा	रोवन
rosario	रोसरियो	रोसारियो
rosariyo	रोसरियों	रोसारियो
raubadaar	रौबदार	रौबदार
raubadar	रौबदार	रौबदार
raubdar	रौबदार	रौबदार
landara	लंडररा	लंगड़ा
langada	लंंगड़ा	लंगड़ा
langda	लांगड़ा	लंगड़ा
langar	लांगर	लंगर
langaron	लंगररों	लंगरों
langron	लैंग्रों	लंगरों
lambi	लंबी	लंबी
lakeer	लाकीर	लकीर
lakir	लाकीर	लकीर
lakiron	लाकरों	लकीरों
lakme	लकमे	लक्मे
lakshmidhar	लक्ष्मीदार	लक्ष्मीधर
lakshmighar	लक्ष्मीघर	लक्ष्मीधर
lakshy	लक्ष्य	लक्ष्य
lakshya	लक्ष्य	लक्ष्य
lakshyon	लक्ष्यों	लक्ष्यों
lux	लक्स	लक्स
laksar	लकससर	लक्सर
luxor	लक्सर	लक्सर
lakhkhi	लख्खी	लख्खी
lagna	लग्ना	लगना
laganewale	लगनेवाले	लगनेवाले
lagnevaaley	लग्नेवाले	लगनेवाले
lagnewale	लग्नेवाले	लगनेवाले
lagega	लगेगा	लगेगा
lajjalu	लजजजलू	लज्जालु
latkate	लटकते	लटकाते
ladki	लड़की	लड़की
ladate	लाड़ते	लड़ते
ladte	लड़़े	लड़ते
ladaai	लड़ाई	लड़ाई
ladai	लड़ाई	लड़ाई
ladaaiyon	लड़ाइयों	लड़ाईयों
ladaeyon	लड़ायों	लड़ाईयों
ladaiyon	लड़ाइयों	लड़ाईयों
lapetane	लपेटने	लपेटने
lapetne	लपेटने	लपेटने
labada	लबबड़ा	लबादा
lbada	लबाड़ा	लबादा
labdh	लाब्ध	लब्ध
lbdh	लब््	लब्ध
lalak	लालक	ललक
lalkarata	लालकररता	ललकारता
lalkarta	लालकर्ता	ललकारता
lalla	लललाा	लल्ला
lavasa	लावसाा	लवासा
lovasa	लोवासा	लवासा
lassi	लासी	लस्सी
lahanaa	लहना	लहना
lahna	लहना	लहना
lehna	लहनाा	लहना
lahraee	लहरायी	लहराई
lahrai	लहराय	लहराई
lehrayi	लहरायी	लहराई
lahalhati	लहलहाटी	लहलहाती
lahlahaati	लहलाहटी	लहलहाती
lahlahati	लहलाहटी	लहलहाती
lahsun	लहससून	लहसुन
lasoon	लासून	लहसुन
lanchar	लांचर	लांचर
launcher	लॉनचर	लांचर
lycopene	लाइकोपन	लाइकोपिन
lime	लाइम	लाइम
lives	लिवेस	लाइव्स
live	लाइव	लाईव
laegi	लाएगी	लाएगी
lagataar	लगताार	लागातार
lagatar	लगातर	लागातार
laata	लाता	लाता
lata	लताा	लाता
laati	लाती	लाती
lati	लति	लाती
layega	लाएगा	लायेगा
lalpur	लालपुर	लालपुर
las	लास	लास्ट
last	लास्ट	लास्ट
lindbhed	लिंडभेड	लिंगभेद
lingbhed	लिंगभेड	लिंगभेद
lindan	लिंदन	लिंडन
lindn	लिंडन	लिंडन
lindon	लिंडों	लिंडन
likhakar	लिखकर	लिखकर
likhkar	लिखकार	लिखकर
ligar	लिगर	लिगर
liger	लाइगर	लिगर
liberation	लाइबेशशन	लिबरेशन
libration	लाइब्रेशन	लिबरेशन
liberation	लाइबेशशन	लिब्रेशन
libration	लाइब्रेशन	लिब्रेशन
leaderon	लीडरों	लीडरों
leedaron	लीडारों	लीडरों
lidaron	लिडारों	लीडरों
liidaron	लीडारों	लीडरों
louis	लुईस	लुईस
luis	लुई	लुईस
ludhakate	लुढ़कते	लुढ़कते
ludhkate	लुढ़कते	लुढ़कते
lurhakate	लुढ़कते	लुढ़कते
lutf	लट्फ	लुत्फ
lumding	लुमडिंग	लुमडिंग
lootmaar	लूटमार	लूटमार
lootmar	लूटमार	लूटमार
landal	लंंल	लेंडल
lendal	लेंडल	लेंडल
lega	लेगा	लेगा
legaa	लेगा	लेगा
letakar	लेटकर	लेटकर
letkar	लेटकर	लेटकर
lenevali	लेनेवाली	लेनेवाली
lenewali	लेनेवाली	लेनेवाली
label	लेबल	लेबल
labeling	लेबलिंग	लेबलिंग
labelling	लेबलिंग	लेबलिंग
labelo	लेबलो	लेबलों
labelon	लेबलों	लेबलों
lebalon	लेबलों	लेबलों
lemon	लेमोन	लेमन
laingadan	लैंगाड़न	लैंगडन
langdon	लांगड़ं	लैंगडन
lengdan	लेंगड़न	लैंगडन
laigikata	लैगिकता	लैंगिकता
laingikta	लैंगिकता	लैंगिकता
lanset	लांसेट	लैंसेट
lenset	लेंसेट	लैंसेट
lairi	लैरी	लैरी
lairy	लैरी	लैरी
larry	लैरी	लैरी
lace	लेस	लैस
less	लेस	लैस
locket	लॉकट	लॉकेट
laundry	लाउंद्र	लॉन्ड्री
longewal	लोंगेवाल	लोंगोवाल
longewala	लोंगेवाला	लोंगोवाल
longoval	लोंगोवल	लोंगोवाल
log	लॉग	लोग
loge	लोज	लोगे
lochdar	लोचड़र	लोचदार
lodi	लोडी	लोदी
laurence	लॉरेंस	लौरेंस
laurens	लारेंस	लौरेंस
laurense	लॉरेंस	लौरेंस
wonder	वंदर	वंडर
vansh	वंश	वंश
vanshdhar	वंशधार	वंशधर
vanshavad	वंशवाद	वंशवाद
vanshvaad	वंशवाद	वंशवाद
vanshvad	वंशवाद	वंशवाद
wanshwad	वंशवाद	वंशवाद
vajood	वजूद	वजूद
vajud	वाजूद	वजूद
wajood	वजूद	वजूद
vadali	वादली	वडाली
vadli	वादली	वडाली
wadali	वादली	वडाली
vanita	वानिता	वनिता
vareinye	वररेन	वरेण्य
varenya	वररेन्या	वरेण्य
varn	वर्न	वर्ण
varna	वर्ना	वर्ण
varnit	वर्ननत	वर्णित
vartamaan	वर्तमान	वर्तमान
vartaman	वर्तमान	वर्तमान
vartmaan	वर्तमान	वर्तमान
vartman	वर्तमान	वर्तमान
varddhaman	वर्द्धमन	वर्द्धमान
vardhmaan	वर्धमान	वर्द्धमान
vardhman	वर्धमान	वर्द्धमान
verbal	वर्बल	वर्बल
varshan	वर्षण	वर्शन
vasharan	वश्रण	वर्शन
vershan	वर्षन	वर्शन
version	वर्शन	वर्शन
varsaache	वर्साचे	वर्साचे
varsaryache	वर्सर्यचच	वर्साचे
vasearche	वायर्चे	वर्साचे
valkan	वाक्कन	वल्कन
valkkan	वाक्कन	वल्कन
velkan	वेल्कन	वल्कन
vash	वाष	वश
vashikaran	वाष्करण	वशीकरण
vaangchuk	वांगछुक	वांगचुक
vangchuk	वंंछुक	वांगचुक
wangchuk	वंंछुक	वांगचुक
want	वांट	वांट
vije	विजे	वाइज
vise	वासे	वाइज
wise	वाइस	वाइज
vatar	वातार	वाटर
water	वाटर	वाटर
watson	वत्सों	वाटसन
wattson	वत्तसों	वाटसन
vaan	वान	वाण
waan	वान	वाण
vaanon	वानों	वाणों
vanon	वनों	वाणों
wanon	वनों	वाणों
vatanukulan	वातानुकूलन	वातानुकूलन
watanukoollan	वाटानुकूल्लन	वातानुकूलन
vaadak	वादक	वादक
vadak	वादक	वादक
vaadiyon	वादियों	वादियों
vadiyon	वादियों	वादियों
wadiyon	वादियों	वादियों
vayana	वायना	वायना
vayna	वायना	वायना
wayna	वायना	वायना
wireless	वायरलेस	वायरलेस
wirerless	वायरललेस	वायरलेस
warrior	वारियर	वारियर्स
warriors	वारियर्स	वारियर्स
valve	वाल्व	वाल्व
wolv	वॉल्व	वाल्व
vastavik	वास्ताविक	वास्तविक
vastvik	वास्त्विक	वास्तविक
vaahikayen	वाहिकाएं	वाहिकाएं
vahikayen	वाहिकाएं	वाहिकाएं
wahikayan	वाहिकाएं	वाहिकाएं
winter	विंटर	विंटर
vincent	विंसेंट	विंसेंट
vikalpon	विकल्पों	विकल्पों
wicket	विकेट	विकेट
vikramjeet	विक्रमजीत	विक्रमजीत
vikramjit	विक्रमजित	विक्रमजीत
vichaarakon	विचारकों	विचारकों
vicharakon	विचारकों	विचारकों
vigyan	विज्ञान	विज्ञान
vigyaani	विज्ञानी	विज्ञानी
vigyani	विज्ञानी	विज्ञानी
vigyaanon	विज्ञानों	विज्ञानों
vigyanon	विज्ञानों	विज्ञानों
vitthal	वित्थल	विट्ठल
viththal	विथथथल	विठ्ठल
vitthal	वित्थल	विठ्ठल
vitark	वितर्क	वितर्क
vidhaaein	विधाएं	विद्याएं
vidyaayein	विद्याएं	विद्याएं
vidyaen	विद्याएं	विद्याएं
vidhaaon	विधाओं	विद्याओं
vidyaaon	विद्याओं	विद्याओं
vidyaon	विद्याओं	विद्याओं
vidhansabhaein	विधानसभाएं	विधानसभाएं
vidhansabhaen	विधानसभाएं	विधानसभाएं
vidhivat	विधिवत	विधिवत
vidhut	विद्युत	विधुत
vinasht	विनाष्ट	विनष्ट
vineet	विनीत	विनीत
vinit	विनीत	विनीत
vipreetataa	विप्रीतता	विपरीतता
vipritata	विपरितता	विपरीतता
vipra	विप्र	विप्रा
vipro	विपरोो	विप्रो
wipro	विपरोो	विप्रो
vibha	विभा	विभा
vibhajak	विभाजक	विभाजक
vibhram	विभ्राम	विभ्रम
vibhrm	विभर्म	विभ्रम
vibram	वाइब्राम	विभ्रम
vimarsh	विमर्ष	विमर्श
vimarsho	विमर्शो	विमर्शों
vimarshon	विमर्षों	विमर्शों
virajati	विराजती	विराजती
virechan	विरेचन	विरेचन
virodh	विरोध	विरोध
virodhabhasi	विरोधाासी	विरोधाभासी
virodhabhason	विरोधाभसों	विरोधाभासों
vividh	विविध	विविध
vivekahin	विवेकहीन	विवेकहीन
vivekheen	विवेखीन	विवेकहीन
visheshan	विशेषण	विशेषण
visheshanon	विशेषणों	विशेषणों
visheshaadhikaar	विशेषाधिकार	विशेषाधिकार
visheshadhikar	विशेषाधिकार	विशेषाधिकार
vishwasaniy	विश्वसनीीय	विश्वसनीय
vishwasniiya	विश्वसनीीय	विश्वसनीय
vishwasaniyata	विश्वसानीयता	विश्वसनीयता
vishwasniiyataa	विश्वस्ीताा	विश्वसनीयता
vishahin	विषाहीन	विषहीन
vishhin	विषिन	विषहीन
vishanu	विषाणु	विष्णु
vishnu	विष्णु	विष्णु
vlc	व्लसस	वीएलसी
weeks	विक्स	वीक्स
veerchand	वीरचंद	वीरचंद
virchand	वीरचंद	वीरचंद
veeresh	वीरेश	वीरेश
viresh	विरेश	वीरेश
vritton	वृत्तों	वृत्तों
vruton	वृतों	वृत्तों
vrutton	वृत्तों	वृत्तों
venkataraman	वेंकटरमण	वेंकटरमन
venkatraman	वेंकटरमण	वेंकटरमन
ved	वेद	वेड
wade	वादे	वेड
wed	वेद	वेड
wedding	वेडिंग	वेडिंग
vediyon	वेदियों	वेदियों
vedon	वेदों	वेदों
venezuela	वेनेजुएल	वेनेजुएला
veronica	वेरोनिका	वेरोनिका
veronika	वेरोनिका	वेरोनिका
weronika	वेरोनिका	वेरोनिका
velvet	वेलवेट	वेलवेट
welwet	वेलवेट	वेलवेट
welder	वेल्डर	वेल्डर
weldor	वेल्डर	वेल्डर
welding	वेल्डिंग	वेल्डिंग
wealth	वेल्थ	वेल्थ
vellur	वेलूर	वेल्लूर
velur	वेलुर	वेल्लूर
vesh	वेश	वेश
wasting	वास्तिंग	वेस्टिंग
westing	वेस्टिंग	वेस्टिंग
wastinghouse	वास्तिंघास	वेस्टिंगहाउस
westinghouse	वेस्टिंघास	वेस्टिंगहाउस
vaisley	वैसलले	वेस्ले
vesle	वेसल	वेस्ले
wesle	वेसल	वेस्ले
vaigyaanik	वैज्ञानिक	वैज्ञानिक
vaigyanik	वैजज्ञानिक	वैज्ञानिक
vegyanik	वेज्ञानिक	वैज्ञानिक
vaigyaanikta	वैज्ञानिकता	वैज्ञानिकता
vaigyanikata	वैज्ञानिकता	वैज्ञानिकता
vaigyanikta	वैज्ञानिकता	वैज्ञानिकता
vaitravati	वैत्रवती	वैत्रवती
vaitrawati	वैत्रवती	वैत्रवती
vaimanasy	वैमानस्य	वैमनस्य
vaimanasya	वैमानस्य	वैमनस्य
vaimanya	वैमान्य	वैमनस्य
very	वेरी	वैरी
vaisaakh	वैसाख	वैशाख
vaishakh	वैशाख	वैशाख
vaishaakhi	वैशाखी	वैशाखी
vaishakhi	वैशाखी	वैशाखी
vaishnodevi	वैश्नोदेवी	वैष्णोदेवी
vyaktigat	व्यक्तिगत	व्यक्तिगत
vyagr	व्याग्र	व्यग्र
vyagra	व्याग्र	व्यग्र
vyatit	व्यतित	व्यतीत
vytit	व्यतित	व्यतीत
vyabhichar	व्याभिचार	व्यभिचार
vyabhichari	व्याभिचारी	व्यभिचार
vyavadhan	व्याधधान	व्यवधान
vyavdhan	व्यवधान	व्यवधान
vyavahargat	व्यवहार्गत	व्यवहारगत
vyvhargat	व्यव्ारगत	व्यवहारगत
vyaghat	व्याघाट	व्याघात
vyapak	व्यापक	व्यापक
vlad	वालाद	व्लाद
wlaad	वलााद	व्लाद
vladimir	व्लादीमीर	व्लादिमीर
shanghai	शंघाई	शंघाई
shatpath	शत्पाठ	शतपथ
shanivar	शननिवर	शनिवार
shaniwar	शनिनवर	शनिवार
shabana	शबाना	शबाना
shbana	शबाना	शबाना
shabdarth	शब्दार्थ	शब्दार्थ
shamadan	शमादन	शमादान
shmadan	शमादन	शमादान
shamitabh	शमषतताभ	शमिताभ
shamil	शममिल	शमिल
shmil	श्मिल	शमिल
sharabon	शरबबों	शराबों
shrabon	शराबों	शराबों
shararat	शरारत	शरारत
shrart	शरररत	शरारत
sharmana	शर्मा	शर्माना
shaharwasiyon	शहरवासियों	शहरवासियों
shahrvasiyon	शहरवासियों	शहरवासियों
shervasiyon	शररवासियों	शहरवासियों
shahdara	शाहदरा	शहादरा
shaantikaal	शांतिकाल	शांतिकाल
shantikal	शांतिकाल	शांतिकाल
shaao	शाओ	शाओ
shao	शाह	शाओ
shaakir	शाकीर	शाकिर
shakir	शाकीर	शाकिर
shaakhaaen	शाखाएं	शाखाएं
shakhayan	शखायन	शाखाएं
shakhayen	शाखाएं	शाखाएं
shayak	श्यक	शायक
shaavakon	शावकों	शावकों
shavakon	शावकों	शावकों
shavkon	श्वकों	शावकों
shaasaka	शासकका	शासक
shasak	शासक	शासक
sasakon	साककों	शासकों
shaasakon	शासकों	शासकों
shasakon	शासकों	शासकों
shipra	शिप्र	शिप्रा
shirke	शिरके	शिर्के
sheershakon	शीर्षकों	शीर्षकों
shirshakon	शिर्षकों	शीर्षकों
shirshkon	शिर्षकों	शीर्षकों
shujaat	शुजात	शुजात
shujat	शुजतत	शुजात
shooting	शूटिंग	शुटिंग
shutting	शट्टिंग	शुटिंग
should	शौल्ड	शुड
shud	शुद	शुड
shubhankar	शुभंकार	शुभंकर
shumaali	शुमाली	शुमाली
shumali	शुमली	शुमाली
shringaar	श्रृंगार	शृंगार
shringar	श्रृंगार	शृंगार
shrungar	शृरगरर	शृंगार
sheling	शेलिंग	शेलिंग
shelling	शेलिंग	शेलिंग
shaili	शैली	शैली
shaly	शल्य	शैली
sheli	शेली	शैली
shaishav	शैश्व	शैशव
sean	सीएन	शॉन
shaun	शौन	शॉन
shawn	श्नन	शॉन
short	शौर्ट	शोर्ट
sure	सुरे	श्योर
shrankhala	श्रृंखला	श्रंखला
shrankhalaa	श्रृंखला	श्रंखला
shrunkhla	शृंखला	श्रंखला
shrankhalaaon	श्रृंलाओं	श्रंखलाओं
shrinkhalaon	शृंखखालाओं	श्रंखलाओं
shrunkhlaon	शृंखलाओं	श्रंखलाओं
shravani	श्रवाणी	श्रावणी
shrikar	श्रीकार	श्रीकर
shrikhand	श्रीखंड	श्रीखंड
shrimati	श्षीमति	श्रीमति
shriram	श्रीराम	श्रीराम
sriram	श्रीराम	श्रीराम
shrotaon	श्रोताओं	श्रोताओं
shat	शतट	षट्
sankhyaein	संख्याएं	संख्याएं
sankhyaen	संख्याएं	संख्याएं
sankhyayen	संख्याएं	संख्याएं
sanghanit	संघनीत	संघनित
sanghnit	संघनीत	संघनित
sanchayan	संचायन	संचयन
sanchar	संचार	संचार
sanchaari	संचारी	संचारी
sanchari	संचारी	संचारी
sanchalanon	संचालनों	संचालनों
sanchalnon	संचलनों	संचालनों
sanjay	संजय	संजय
sanjeevan	संजीवन	संजीवन
sanjivan	संजीवन	संजीवन
santati	संततती	संतति
sandarbh	संदर्भ	संदर्भ
sandarbha	संदर्भा	संदर्भ
sandrbh	संद्रभ	संदर्भ
sandarbhon	संदर्भों	संदर्भों
sandrbhon	संद्रभों	संदर्भों
sandali	सांडली	संदली
sandli	सांडली	संदली
sandhan	संधन	संधान
samprati	संप्रति	संप्रति
samprti	संप्रति	संप्रति
samprabhu	संप्रभू	संप्रभु
samprbhu	संप्रभू	संप्रभु
samprabhuta	संप्रभूता	संप्रभुता
samprbhuta	संप्रभूता	संप्रभुता
sambit	संबित	संबित
sambhalane	संभालने	संभालने
sambhalne	संभालने	संभालने
sambhrant	संभरांत	संभ्रांत
sanbharnt	संभारंत	संभ्रांत
sanyog	संयोग	संयुक्त
sanyukt	संयुुक्त	संयुक्त
sanyukta	सायुुक्त	संयुक्त
sanyukta	सायुुक्त	संयुक्ता
sanyogvash	संयोग्वाश	संयोगवश
sanyojan	संयोजन	संयोजन
sanyojanon	संयोजनों	संयोजनों
sanyojnon	संयोजनों	संयोजनों
samvedikaran	संवेदीकरण	संवेदीकरण
sanvedikaran	संवेदीकरण	संवेदीकरण
samshayon	समशायों	संशयों
sanshayon	संशायों	संशयों
sanshyon	संश्यों	संशयों
sanskaar	संस्कार	संस्कार
sanskar	संस्कार	संस्कार
sanskaari	संस्कारी	संस्कारी
sanskari	संस्कारी	संस्कारी
sanskrit	संस्कृत	संस्कृत
sanskurt	संस्कृत	संस्कृत
sanskritiyan	संस्कृतियां	संस्कृतियां
sanskrutiyan	संस्कृतियां	संस्कृतियां
sanskritiyon	संस्कृतियों	संस्कृतियों
sanskrutiyon	संस्कृतियों	संस्कृतियों
sanasthit	सनस्थथित	संस्थित
sansthit	संस्थित	संस्थित
sanasthita	सनसस्थिता	संस्थिता
sansthita	संस्थिता	संस्थिता
sakara	सकााा	सकरा
sakra	सक्र	सकरा
sakshan	साक्षण	सक्शन
suction	सक्शन	सक्शन
sacchidanand	सच्चिदानंद	सच्चिदानंद
sachhidanand	सच्चिदननंद	सच्चिदानंद
sachidanand	सचिदानंद	सच्चिदानंद
sajja	सज्जा	सज्जा
sat	सत	सत
satpal	सत्पाल	सतपाल
satluj	सतलूूज	सतलुज
sataane	सताने	सताने
satane	सतनने	सताने
sate	साट	सते
satti	सत्ती	सत्ती
satvat	सत्वत	सत्वत
sadanand	सदानंद	सदानंद
sapane	सपाने	सपने
sapne	सपने	सपने
sapney	सपने	सपने
saparivaar	सपरिवार	सपरिवार
sapariwar	सपरिवार	सपरिवार
sparivar	स्परिवार	सपरिवार
sapaat	सपात	सपाट
sapat	सपात	सपाट
sapate	सपाते	सपाटे
sapatey	सपतेे	सपाटे
saptakranti	सप्तक्रांति	सप्तक्रांति
saptkraanti	सप्तक्रांति	सप्तक्रांति
saptapadi	सप्तपादी	सप्तपदी
saptpadi	सप्तपादी	सप्तपदी
saptari	सप्तरी	सप्तरी
sapramaan	सप्रमाण	सप्रमाण
sapraman	सप््रमण	सप्रमाण
submit	सब्मित	सबमिट
sabmission	सब्मिशन	सबमिशन
submission	सबमीशशन	सबमिशन
sabhaein	सभाएं	सभाएं
sabhaen	सभाएं	सभाएं
sabhayen	सभाएं	सभाएं
sabhen	सभें	सभाएं
sabhasadon	सभासदों	सभासदों
sabhyata	सभ्यता	सभ्यता
samjhoonga	समझूंगा	समझूंगा
samjhunga	समझुंगा	समझूंगा
samjhungaa	समझुंगा	समझूंगा
saman	सामान	समन
samanvayaka	समन्वायक	समन्वयक
samanwayaka	समन्वयका	समन्वयक
samnvyak	समन्व्यक	समन्वयक
samaadhaan	समाधान	समाधान
samadhan	समाधन	समाधान
samadhiyon	समाधियों	समाधियों
samadjiyon	समद्जियों	समाधियों
samalakha	समाला	समालखा
samalakhaa	समाला	समालखा
samahaar	समाहार	समाहार
samahar	समहर	समाहार
samitiyan	समितियां	समितियां
sametati	समेतती	समेटती
sametti	समेट्ी	समेटती
sarka	सर्ा	सरका
sarkaa	सरका	सरका
sarkarein	सरकारें	सरकारें
sarkaren	सरकारें	सरकारें
sarkaaron	सर्कारों	सरकारों
sarkaron	सर्कारों	सरकारों
sargana	सर्गनाा	सरगना
sarganaon	सरगणाओं	सरगनाओं
sargi	सर्ीी	सरगी
sarguja	सरगुजा	सरगुजा
sarjuga	सरजुगा	सरगुजा
sarsa	सर्सा	सरसा
sarsaa	सरसा	सरसा
sarahind	सरहिंद	सरहिंद
sarhind	सरहिंद	सरहिंद
sirhind	सिरहिंद	सरहिंद
saraaha	सराहा	सराहा
saraha	सााह	सराहा
saraahi	सराही	सराही
sarahi	साराही	सराही
salaahkar	सलाहकर	सलाहकार
salahkaar	सलाहार	सलाहकार
salahkar	सलाहकर	सलाहकार
saleeb	सलीब	सलीब
salib	सालिब	सलीब
select	सेलेक्ट	सलेक्ट
saltanat	सल्तानत	सल्तनत
saltnat	सल्टनात	सल्तनत
savaal	सवाल	सवाल
saval	सावल	सवाल
sawaal	सवाल	सवाल
sawal	सावल	सवाल
sahakalaakar	सहकलाकार	सहकलाकार
sahakalakar	सहकलकार	सहकलाकार
sahkalakar	सहकलकार	सहकलाकार
sahadev	सहादेव	सहदेव
sahdev	सहदेव	सहदेव
sahrawat	सहरावत	सहरावत
sherawat	शेरावत	सहरावत
sahooliyata	सहूलीयता	सहूलियत
sahuliyat	सहूलियत	सहूलियत
sahuuliyata	सहूलीयता	सहूलियत
saanketika	सांकेतिका	सांकेतिक
sanketik	सांकेतिक	सांकेतिक
saimans	सैममंस	साइमंस
simmons	सिममोंस	साइमंस
symons	सायमोंस	साइमंस
saima	सैमामा	साइमा
sagarika	सागरिका	सागरिका
sagrika	सागरीकका	सागरिका
saga	सागा	सागा
saajan	साजन	साजन
sajan	सजनन	साजन
saajsajja	साजसज्ज	साजसज्जा
sajsajja	सजसजज्ज	साजसज्जा
saja	सजा	साजा
saathsaath	साथसाथ	साथसाथ
sathsath	सथससथ	साथसाथ
sathiya	सथीया	साथिया
saabah	साबहह	साबाह
sabah	सबाह	साबाह
samanjasy	समांजस्य	सामंजस्य
samanjasya	समंजस्य	सामंजस्य
samoa	समोम	सामोआ
samoaa	समोआ	सामोआ
saayn	सायनन	सायं
sayan	सायन	सायं
saym	सेयम	सायं
saira	सैरा	सायरा
sayara	सायरा	सायरा
sayra	सेयरा	सायरा
salve	साल्व	साल्वे
sahab	सहाब	साहब
singapore	सिंगापोर	सिंगापुर
singaar	सिंगार	सिंगार
singar	सिंगर	सिंगार
singer	सिंगर	सिंगार
singhaadey	सिंघाड़े	सिंघाड़े
singhade	सिंहडे	सिंघाड़े
singhde	सिंहडे	सिंघाड़े
singhre	सिंघरे	सिंघाड़े
singhi	सिंघी	सिंघी
singha	सिंघा	सिंहा
sinha	सिन्हा	सिंहा
siera	सियरा	सिएरा
sierra	सियरा	सिएरा
sikud	सिकुड़	सिकुड़
signals	सिग्नल्स	सिगनल्स
cigaretton	सिगरेटों	सिगरेटों
cigretton	सागररटों	सिगरेटों
siddhivat	सिद्धिवत	सिद्धवट
siddhvat	सिद्धवत	सिद्धवट
siddhwat	सिद्धवत	सिद्धवट
sinabang	सीनाबंग	सिनाबंग
synapse	साइपेस	सिनेप्स
sipah	सिपहह	सिपाह
sipaha	सिपहा	सिपाह
sipahiyon	सिपहियों	सिपाहियों
sipahi	सिपाही	सिपाही
sim	सिम	सिम
simat	सीमत	सिमट
simatataa	सीमततता	सिमटता
simatta	सीमत्ता	सिमटता
simtata	सिमटतता	सिमटता
simtataa	सिमततता	सिमटता
cement	सीमेंट	सिमटे
simate	सीमते	सिमटे
simi	सिमी	सिमी
simmy	सिमी	सिमी
sims	सिमस	सिम्स
siyasi	सियससी	सियासी
siyah	सियाह	सियाह
siyaha	सियाहा	सियाह
sirpur	सीरपुर	सिरपुर
sivan	सिवान	सिवान
siwan	सिवान	सिवान
sisva	सिस्व	सिसवा
siswa	सिस्वा	सिसवा
cil	सिल	सीआईएल
csi	सीसी	सीएसआई
sikar	सिकार	सीकर
seaten	सीएटन	सीटें
sitaram	सीताराम	सीताराम
sitaharan	सीताहरण	सीताहरण
cpm	सीपीएम	सीपीएम
cps	सीपीस	सीपीएस
cbse	स्ब्स	सीबीएसई
seem	सीम	सीम
sim	सिम	सीम
sealed	सीएलेड	सील्ड
shield	शील्ड	सील्ड
ccd	सीसीडी	सीसीडी
sugamata	सुगमताा	सुगमता
sugmta	सुग्मता	सुगमता
sujan	सुजन	सुजेन
sujen	सुजेन	सुजेन
suken	सुकेन	सुजेन
sujain	सुजैन	सुजैन
sujhaati	सुझाती	सुझाती
sujhati	सुझाती	सुझाती
sutali	सुतली	सुतली
sutli	सुतली	सुतली
suta	सूता	सुता
sdueep	स्दुीप	सुदीप
sudip	सुदीप	सुदीप
sudhaargrah	सुधारग्रह	सुधारगृह
sudhargrih	सुधारग्रह	सुधारगृह
sudhargruh	सुधारग्रह	सुधारगृह
sunaaron	सुनारों	सुनारों
sunaron	सुनरों	सुनारों
sunaseer	सुनसीरर	सुनासीर
sunasir	सुनासीर	सुनासीर
suneeti	सुनीति	सुनीति
suniti	सुनीति	सुनीति
sunega	सुनेगा	सुनेगा
suneyga	सुनेगा	सुनेगा
superhit	सुपेहित	सुपरहिट
supachy	सुपा्ची	सुपाच्य
supachya	सुपा्या	सुपाच्य
supachye	सुपा्य	सुपाच्य
subhaay	सुभाय	सुभाय
subhay	सुभ्य	सुभाय
surveen	सर्वीन	सुरवीन
survin	सर्विन	सुरवीन
surana	सुराना	सुराणा
sulkhan	सुलखान	सुलखान
suljaayi	सुलजाई	सुलझाई
suljayi	सुलजाई	सुलझाई
suljhai	सुलझाई	सुलझाई
sulzai	सुलजाई	सुलझाई
sultana	सुल्ताना	सुलताना
sulaati	सुलाती	सुलाती
sulati	सुलती	सुलाती
susanskrit	सुसंस्कृत	सुसंस्कृत
susanskrut	सुसंस्कृत	सुसंस्कृत
suhagin	सुहागीन	सुहागिन
soond	सूंद	सूंड़
sund	सुंड	सूंड़
suiyan	सुइयान	सूइयां
sukhati	सुखती	सूखती
sukhti	सूखती	सूखती
sukhakar	सुखाकर	सूखाकर
soochak	सूचक	सूचक
suchak	सूचक	सूचक
sooja	सूजा	सूजा
suja	सुजा	सूजा
suba	सुबा	सूबा
sube	सुबे	सूबे
sooraj	सूरज	सूरज
suraj	सुरज	सूरज
surinaam	सुरीनाम	सूरीनाम
surinama	सुरीनामा	सूरीनाम
suriname	सुरीनाम	सूरीनाम
suryadev	सूर्यादवव	सूर्यदेव
sendha	सेंधा	सेंधा
senvai	सेनवाई	सेंवई
sevai	सेवाई	सेंवई
sensing	सेंसिंग	सेंसिंग
sexual	सेक्स्यल	सेक्सुअल
saturday	सतूर्दय	सेटरडे
seti	सेती	सेटी
seto	सीटो	सेटो
seth	सेठ	सेथ
safety	सफफ़्टी	सेफ्टी
semen	सेमेन	सेमिन
semin	सेमिन	सेमिन
self	सेल्फ	सेल्फ
selfie	सेल्फी	सेल्फी
save	साव	सेव
sev	सेव	सेव
sevakon	सेवकों	सेवकों
sevkon	सेवकों	सेवकों
samuels	सममयूल्स	सैम्युल्स
celery	सेलेरी	सैलरी
salary	सालारी	सैलरी
sakar	साकार	सॉकर
socar	सोकार	सॉकर
soccer	सॉक्सर	सॉकर
songs	सांग्स	सॉन्ग्स
solicitor	सोलीसीटर	सॉलिसिटर
sochane	सोचने	सोचने
sochne	सोचने	सोचने
sonu	सोनु	सोनू
soma	सोमा	सोमा
spma	स्प्मा	सोमा
somi	सोमी	सोमी
soy	सोय	सोय
soya	सोया	सोया
solitaire	सोलीटेयर	सोलिटेयर
soharai	सोहराय	सोहराई
sohrai	सोहराय	सोहराई
sohaval	सोहावल	सोहावल
sohawal	सोहावल	सोहावल
saunpane	सौनपाने	सौंपने
sonpne	सौंपने	सौंपने
scala	स्कलला	स्काला
skala	स्कला	स्काला
ski	स्की	स्की
scootaron	स्कूतरों	स्कूटरों
scooteron	स्कूटरों	स्कूटरों
skootaron	स्कूतरों	स्कूटरों
scandinavia	स्कैंडीनेविया	स्कैंडिनेविया
scaining	स्कैनिंग	स्कैनिंग
scanning	स्कैनिंग	स्कैनिंग
squash	स्क्वाश	स्क्वाश
squash	स्क्वाश	स्क्वैश
skhalan	स्खलन	स्खलन
stain	स्टेन	स्टैन
stan	स्तनन	स्टैन
stop	स्टॉप	स्टॉप
stops	स्टॉप्स	स्टॉप्स
stone	स्टोन	स्टोन
straws	स्ट्रॉस	स्ट्रास
stress	स्ट्रेस	स्ट्रास
stra	स्तर	स्ट्रे
stray	स्तररय	स्ट्रे
stre	स्टरर	स्ट्रे
strocks	स्ट्रॉक्स	स्ट्रोक्स
strokes	स्ट्रोक्स	स्ट्रोक्स
stan	स्तनन	स्तन
stanadhari	स्तनधारी	स्तनधारी
standhaari	स्तनधारी	स्तनधारी
standhari	स्तनधारी	स्तनधारी
sthiti	स्थिति	स्तिथि
stithi	स्तिथि	स्तिथि
stuti	स्तुति	स्तुति
sthitiyaan	स्थितियां	स्थितियां
sthitiyan	स्थितियां	स्थितियां
sthitiyon	स्थितियों	स्थितियों
sthool	स्थूल	स्थूल
sthul	स्थौल	स्थूल
sthoolta	स्थूलता	स्थूलता
sthulata	स्थौलता	स्थूलता
sneakers	स्नेकर्स	स्नीकर्स
snickers	स्निकर्स	स्नीकर्स
snikarse	स्निकार्स	स्नीकर्स
spear	स्पेयर	स्पीयर
spell	स्पेल	स्पेल
spelar	स्पेलर	स्पेलर
speller	स्पेलर	स्पेलर
sprint	स्प्रिंट	स्प्रिट
sprit	स्प्रिट	स्प्रिट
spray	स्प्रेय	स्प्रे
spry	स्प्री	स्प्रे
sfoorti	स्फूर्ति	स्फूर्ति
sfurti	स्फूर्ति	स्फूर्ति
sphoorti	स्फूर्ति	स्फूर्ति
slide	स्लाइड	स्लाइड
slider	स्लाइडर	स्लाइडर
slaaidon	स्लाइडों	स्लाइडों
slidon	स्लीडों	स्लाइडों
sliders	स्लाइडर्स	स्लाइड्स
slides	स्लाइड्स	स्लाइड्स
slice	स्लाइस	स्लाइस
slash	स्लाश	स्लैश
swaroopon	स्वरूपों	स्वरुपों
swarupon	स्वरूपों	स्वरुपों
swa	स्वा	स्वा
swaachaalit	स्वाचालित	स्वाचालित
swachalit	स्वचालित	स्वाचालित
swaarthparak	स्वार्थपरक	स्वार्थपरक
swarthparak	स्वार्थपरक	स्वार्थपरक
swiftlate	स्विफ्टलेट	स्विफ्टलेट
swiftlet	स्विफ्टल	स्विफ्टलेट
sweekarte	स्वीकारते	स्वीकारते
swikarte	स्वीकारते	स्वीकारते
sweet	स्वीत	स्वीट
sweep	स्वीप	स्वीप
sweccha	स्वेच्छा	स्वेच्छा
swecha	स्वेच्छ	स्वेच्छा
swechha	स्वेच्छ	स्वेच्छा
sweta	स्वेटा	स्वेता
swap	स्वपप	स्वैप
swipe	स्विपी	स्वैप
handiya	हांडिया	हंडिया
handiyaa	हंडडिया	हंडिया
hundiya	हंडिया	हंडिया
hakikat	हकीकत	हकीकत
haqeeqat	हकीकत	हकीकत
hathiya	हठिया	हथिया
hamala	हमलला	हमला
hamla	हमला	हमला
hamalavar	हमलावर	हमलावर
hamlavar	हमलावर	हमलावर
humlavar	हमलावर	हमलावर
hamaal	हमाल	हमाल
hamal	हमल	हमाल
hercules	हर्कुल्स	हरक्यूलिस
hardas	हरदासस	हरदास
harpaal	हरपाल	हरपाल
harpal	हरपाल	हरपाल
harvansh	हरववंश	हरवंश
haraval	हरावल	हरावल
harawal	हराववल	हरावल
hurricane	हररिककनन	हरिकेन
harijan	हरीजन	हरिजन
hariyali	हरियाली	हरियाली
harshit	हर्शित	हर्षित
haldi	हालडीी	हल्दी
halla	हल्ला	हल्ला
hawamahal	हववमहाल	हवामहल
hawalaat	हवालाट	हवालात
hawalat	हवालत	हवालात
hasino	हसीनोो	हसीनों
hasinon	हसीनों	हसीनों
haan	हान	हां
han	हान	हां
haanfte	हांफते	हांफते
hafate	हफाते	हांफते
hanfte	हांफटे	हांफते
higman	हिग्मान	हाइमन
hymen	हामेे	हाइमन
hadauti	हड़ौती	हाड़ौती
haani	हानी	हानी
hani	हानी	हानी
haarjeet	हारजीत	हारजीत
harjeet	हरजीत	हारजीत
haaranaa	हारणा	हारना
harana	हराणा	हारना
harna	हरणा	हारना
haalchaal	हालचाल	हालचाल
haalchal	हालचल	हालचाल
halchaal	हलचाल	हालचाल
halchal	हलचल	हालचाल
halt	हाल्ट	हाल्ट
hault	हॉल्ट	हाल्ट
hahakar	हहकर	हाहाकार
hingis	हिंगिस	हिंगिस
hindan	हिंदनन	हिंडन
hindon	हिंदों	हिंडन
hijada	हिजड़ा	हिजड़ा
hijda	हिजड़ा	हिजड़ा
hijbul	हिजबुल	हिजबुल
hippo	हिप्पो	हिप्पो
hippopotamus	हिप्पोटाममस	हिप्पोपोटेमस
himali	हिमाली	हिमाली
hilane	हिलनन	हिलने
hilne	हिलने	हिलने
hisham	हिशम	हिशाम
heeraganj	हीरगंज	हीरागंज
hiraganj	हीरगंज	हीरागंज
heroes	हेरोजस	हीरोज
heros	हेरोस	हीरोज
hui	हुई	हुईं
huin	हुएन	हुईं
hooper	हूपर	हूपर
huppar	हुप्र	हूपर
hupper	हप्रर	हूपर
hegde	हेगडे	हेगडे
hemvati	हेमवती	हेमवती
hemwati	हेमवतीी	हेमवती
help	हेल्प	हेल्प
helper	हेल्पर	हेल्पर
haito	हैटो	हैतो
hairam	हैराम	हैरम
harem	हरेम	हैरम
herald	हेराल्ड	हैराल्ड
haive	हैववव	हैव
have	हावे	हैव
hong	होंग	हॉन्ग
half	हालफफ	हॉफ
hoaf	होफफ	हॉफ
hounga	हाउंगा	होऊंगा
holding	होल्डिंग	होल्डिंग
hoshangabaad	होशांगाड़	होशंगाबाद
hoshangabad	होशांगाब़	होशंगाबाद
hostes	हॉस्ट्स	होस्टेस
hostess	हॉस्टेस	होस्टेस
