ank	अंक	अंक
anka	अंका	अंक
ankit	अंकित	अंकित
anakon	अनाकों	अंकों
ankhon	अंखों	अंकों
ankon	अंकों	अंकों
angkor	अंगकोर	अंकोर
ankor	अंकोर	अंकोर
angaarak	अंगारकक	अंगारक
angarak	अंगारक	अंगारक
angraji	अंग्रजी	अंग्रज़ी
angreji	अंग्रेजी	अंग्रज़ी
angrzi	अंग्रजी	अंग्रज़ी
antah	अंताह	अंतः
antaha	अंताह	अंतः
antarmukh	अंतरममुक	अंतर्मुख
antmurkh	अंतरमुक	अंतर्मुख
antrmukh	अंतर्मुख	अंतर्मुख
andrabee	अंदरबीी	अंद्राबी
andrabi	अंदरबीी	अंद्राबी
andha	अंधा	अंधा
andhapan	अंधापपन	अंधापन
andheri	अंधेरी	अंधेरी
ambaani	अंबानी	अंबानी
ambani	अमबानी	अंबानी
akram	आक्रम	अकरम
acapulco	आकापक्लिक	अकापुल्को
akapulko	अकापुलकक	अकापुल्को
akhand	अखांड	अखंड
akhil	अखिलील	अखिल
agavai	अगवाई	अगवाई
agvaai	अगवाई	अगवाई
augustine	अगस्टीनन	अगस्टाइन
augustustine	उगससस््््नननन	अगस्टाइन
agsta	अगस्ता	अगस्ता
agusta	जगुसता	अगस्ता
augusta	उगसुसत	अगस्ता
agr	अग्र	अग्र
agra	अगरा	अग्र
achambha	अचंभा	अचंभा
achanbha	अचंभा	अचंभा
achievement	अधिवेमेंट	अचीवमेंट
achivement	अचिवेमेंट	अचीवमेंट
acchi	अच्छी	अच्छी
achchi	अच्छी	अच्छी
achhi	अछी	अच्छी
achyut	अच्युत	अच्युत
achhanera	अचानर्णा	अछनेरा
achnera	अचेनर	अछनेरा
ajmeedh	अजमीद	अजमीढ़
ajhar	आज़र	अजहर
azhar	आज़र	अजहर
ajit	अजीत	अजित
agnat	अज्नात	अज्ञात
agyaat	अज्ञात	अज्ञात
agyat	अज्ञात	अज्ञात
atakta	अतक्ता	अटकता
atkata	अतकका	अटकता
atake	अतकक	अटके
atke	अटके	अटके
atwaal	अत्वाल	अटवाल
atwal	अत्वाल	अटवाल
attahasa	आत्हासा	अट्टहास
atthaas	अत्थास	अट्टहास
atthas	अत्थास	अट्टहास
addon	एडडों	अड्डों
athak	अठक	अथक
atharv	अथार्व	अथर्व
atharva	अथररवा	अथर्व
adad	अडदा	अदद
adaani	अदानी	अदाणी
adani	अदानी	अदाणी
advait	एडवात	अद्वैत
adwait	एडवात	अद्वैत
advaitvaad	अदववततवाद	अद्वैतवाद
advaitwad	अडववततवाद	अद्वैतवाद
adhivas	अधिवास	अधिवास
adhiwas	अधिवास	अधिवास
advivas	अदवविसास	अधिवास
adhiik	आधिक	अधीक
adhik	आधिक	अधीक
adhyayanarat	अध्ययनररत	अध्ययनरत
adhyayanrat	अध्ययनर्त	अध्ययनरत
adhyaynrat	अध्ययनर्त	अध्ययनरत
anant	अनांत	अनंत
ananti	अनानती	अनंती
angadh	अंगाध	अनगढ़
angarh	अंगार	अनगढ़
anchahe	अंचहे	अनचाहे
anthak	अंठक	अनथक
unthak	उंठक	अनथक
anhoni	अनोहोनी	अनहोनी
anaavashyak	अनावश्यक	अनावश्यक
anavashyak	अनावश्यक	अनावश्यक
anavshyak	अनावश्यक	अनावश्यक
anawashyak	अनावश्यक	अनावश्यक
anik	अनिक	अनिक
anishwarvadi	अनिश्वर्वादी	अनीश्वरवादी
anishwarwadi	अनिश्वर्वादी	अनीश्वरवादी
anukoltha	अनुकोल्ता	अनुकूलता
anukulata	अनुकुलता	अनुकूलता
anukulta	अनुकुलता	अनुकूलता
anuchit	अनुचित	अनुचित
anuprayogi	अनुप्ययोगी	अनुप्रयोगों
anuprayogon	अनुप्ययोगों	अनुप्रयोगों
anupryogon	अनुप्ययोगों	अनुप्रयोगों
anureet	अनुरीत	अनुरीत
anurit	अनुरित	अनुरीत
anuthi	अनुथी	अनूठी
anudit	अनुदित	अनूदित
anyaay	अन्याय	अन्याय
anyay	अन्याय	अन्याय
anyaya	अन्याय	अन्याय
apnani	अपनानी	अपनानी
aparivartanshali	अपरिवत्वाशील	अपरिवर्तनशील
aparivartansheel	अपरिवत्नाशी	अपरिवर्तनशील
aparivartanshil	अपरिवत्वाशिल	अपरिवर्तनशील
apariharya	अपरिहार्य	अपरिहार्य
aprihary	अपरिहार्य	अपरिहार्य
apriyary	अप्रियर्य	अपरिहार्य
apavartit	अपर्वतित	अपवर्तित
apvartit	अपर्वतित	अपवर्तित
apvtrit	अप्रवृत	अपवर्तित
apaardarshi	अपरादरशी	अपारदर्शी
apardarshi	अपरादश्श	अपारदर्शी
afroj	अफ्रोज़	अफरोज
afroz	अफ्रोज़	अफरोज
africa	अफ्रिका	अफ्रीका
abbaasi	अब्बासी	अब्बासी
abbasi	अब्बासी	अब्बासी
abhimat	अभिमात	अभिमत
abhishap	अभिषपप	अभिशाप
abhi	अभी	अभी
amjhera	अमझेरा	अमझेरा
amzera	अमजेरा	अमझेरा
amargad	अमरगगा	अमरगढ़
amargarh	आमरगगर	अमरगढ़
amarpaal	अमरपााल	अमरपाल
amarpal	अमरपपल	अमरपाल
amarohi	अमरोही	अमरोही
amrohi	अमरोही	अमरोही
amaanat	अमानत	अमानत
amanat	अमानत	अमानत
amanth	अमांत	अमानत
amaanati	अमानती	अमानती
amanathi	अमानथथ	अमानती
amanati	अमानती	अमानती
amavasya	आमावस्य	अमावस्या
amavsya	आमावस्य	अमावस्या
amit	अमिट	अमित
amitao	अमिताओं	अमिताव
amitav	अमितवव	अमिताव
amuk	अमूक	अमुक
amogh	अमोग	अमोघ
ambani	अमबानी	अम्बानी
ayodhyaanaath	अयोग्यनाथ	अयोध्यानाथ
ayodhyanaath	अयोग्यनाथ	अयोध्यानाथ
ayodhyanath	अयोध्यनाथ	अयोध्यानाथ
ayodhyeanath	अयोग्यनाथा	अयोध्यानाथ
aradas	अरादसस	अरदास
ardaas	अरदास	अरदास
ardas	अरददास	अरदास
arabab	अरबबब	अरबाब
arbab	अरबबब	अरबाब
around	अरुउंड	अराउंड
arjent	अर्जेंट	अर्जेंट
urgent	उर्जेंट	अर्जेंट
arth	आर्थ	अर्थ
artha	अर्थ	अर्थ
earth	एरथ	अर्थ
earthquake	इर्थ्केकक	अर्थक्वेक
arthon	आर्थों	अर्थों
arpit	अर्पित	अर्पित
aryama	आर्यमा	अर्यमा
aryma	आर्यमा	अर्यमा
arymaa	आर्यमा	अर्यमा
alankaar	अलंकार	अलंकार
alankar	अलंककर	अलंकार
alnkaar	अलंकार	अलंकार
alankaaron	अलंकारों	अलंकारों
alankaron	अलंकारों	अलंकारों
alnkaaron	अलंकारों	अलंकारों
alnkaron	अलंकारों	अलंकारों
alagavavadi	अलगाववादी	अलगाववादी
algavvadi	अल्गववादी	अलगाववादी
algavwaadi	अल्गववादी	अलगाववादी
alive	अलीवा	अलाइव
alance	अलानसस	अलायंस
alayans	अलययंस	अलायंस
aliance	एलियनसस	अलायंस
alind	अलींंड	अलिंद
alai	अलाई	अली
ali	एली	अली
alii	आली	अली
alonso	आलोसनोस	अलोंसो
aloso	एलोसों	अलोंसो
alphabet	अल्रेबेट	अल्फ़ाबेट
alba	अल्बा	अल्बा
avantipur	अवतततपुर	अवंतिपुर
awantipora	अवततपपपरर	अवंतिपुर
avaru	अवरू	अवरु
avru	अवरु	अवरु
awaru	अवररु	अवरु
avarodhak	अवरोधक	अवरोधक
avrodhak	अवरोधक	अवरोधक
avrodhk	अवरोधक	अवरोधक
avarnata	अवर्णता	अवर्णता
avarnataa	अवर्णता	अवर्णता
avranta	अवरंणता	अवर्णता
avashist	अवशिष्त	अवशिष्ट
avshisht	अविष्ट्ट	अवशिष्ट
awashist	अवशिष्ट	अवशिष्ट
avasthaayen	अवस्थाएं	अवस्थाएं
avsthaen	अवस्थाएं	अवस्थाएं
avsthayen	अवस्थाएं	अवस्थाएं
awasthaen	अवस्थाएं	अवस्थाएं
avi	आवी	अवि
avika	आविका	अविका
aviral	अविरल	अविरल
avirl	अविर्ल	अविरल
avishvaasniy	अविश्वासनी	अविश्वसनीय
avishvasniy	अविश्वासनी	अविश्वसनीय
avishvasniya	अविश्वासनीय	अविश्वसनीय
avisvasniya	अविव्वासीय	अविश्वसनीय
aviva	अविवा	अवीवा
avaigyanic	अवैग्ञनिि	अवैज्ञानिक
avaigyanik	अवैज्ञनििक	अवैज्ञानिक
avegyanik	अवैज्ञानिक	अवैज्ञानिक
ashaktataa	आशक्तता	अशक्तता
ashktta	अशक्तता	अशक्तता
asharaphi	आशाराही	अशरफी
ashrafi	अश्रफी	अशरफी
ashariri	आशारिरी	अशरीरी
ashriri	अश्रीरी	अशरीरी
ashrvatath	अश्रवत्थ	अश्वत्थ
ashvtth	अश्वत्थ	अश्वत्थ
asamaany	असामान्य	असमान्य
asamany	असामान्य	असमान्य
asmanye	अस्मान्य	असमान्य
asaamnjsy	असमंजसीय	असामंजस्य
asamanjasy	असमजजज्य	असामंजस्य
asamanjasya	असमजाज्या	असामंजस्य
asurakshit	असुरक्षित	असुरक्षित
asurkshit	असुरक्षित	असुरक्षित
aset	असेट	असेट
asset	एसेट	असेट
asvabhavik	अस्वाभाविक	अस्वभाविक
aswabhavik	अस्वाभाविक	अस्वभाविक
aswbhavik	अस्भावियिक	अस्वभाविक
ahirauli	अहिरौबी	अहिरौली
item	इतीम	आइटम
items	इतीम्स	आइटम्स
idle	इडडल	आइडल
idol	इडडोल	आइडल
icc	इइक्क	आइसीसी
iso	इइसो	आइसो
ipc	इपपक	आईपीसी
ipad	इपाद	आईपैड
iris	इिरिस	आईरिस
ounce	आननस	आउंस
aakaash	आकाशक	आकाश
aakash	आकाश	आकाश
aake	आके	आके
aakhet	आखेते	आखेट
akhet	अखेत	आखेट
aagat	आगत	आगत
aagaman	आगममन	आगमन
aagman	आगमान	आगमन
aagaa	आगा	आग़ा
aagah	आगाह	आग़ा
agha	आघा	आग़ा
aagaashe	आगाशे	आगाशे
aagashe	आगाशे	आगाशे
agashe	अगश्श	आगाशे
aajmaanaa	आजमाना	आजमाना
aajmana	आजमाना	आजमाना
aazmaanaa	आजमाना	आजमाना
aata	आता	आटा
ata	अता	आटा
atta	अत्ता	आटा
aatmayen	आत्माएं	आत्माएं
atmaen	आत्माएं	आत्माएं
aadaan	आदान	आदान
aadan	आदान	आदान
aadhaarit	आधारित	आधारित
aadharit	आधारित	आधारित
adharit	आधारित	आधारित
aadheen	आधीन	आधीन
aadhin	आधीन	आधीन
aadhunik	आधुनिक	आधुनिक
aanad	आनाद	आनद
aanand	आनंद	आनद
anand	अनंद	आनद
aapka	आपका	आपका
aapkaa	आपका	आपका
aapadaaaen	आपदाएं	आपदाएं
aapdaein	आपदाएं	आपदाएं
aapdayein	आपदाएं	आपदाएं
aabantit	आबंतित	आबंटित
abantit	अबंतित	आबंटित
aabru	आबररु	आबरू
abaru	अबररु	आबरू
aamdan	आमदान	आमदन
amadan	अमादन	आमदन
aamdani	आमदानी	आमदनी
amadani	अमादनी	आमदनी
aamdi	आमदी	आमदी
amdi	अम्ीी	आमदी
aamod	आमोड	आमोद
amod	अमोड	आमोद
aayenge	आयेंगे	आयेंगे
aayojak	आयोजकक	आयोजक
ro	रो	आरओ
rp	र्पा	आरपी
aaraam	आराम	आराम
aaram	आराम	आराम
aram	अराम	आराम
aarushi	आरुशि	आरुषि
arushi	अरुशि	आरुषि
artery	आर्टेरी	आर्टरी
order	ऑर्डर	आर्डर
aary	आर्य	आर्य
aarya	आर्य	आर्य
arya	आर्य	आर्य
aaryika	आर्यिका	आर्यिका
aryika	आर्यिका	आर्यिका
aarya	आर्य	आर्यो
arya	आर्य	आर्यो
aryo	आर्यों	आर्यो
aaryan	आर्यान	आर्यों
arya	आर्य	आर्यों
aryon	आर्यों	आर्यों
aalsi	आल्सी	आलसी
alasi	अलासी	आलसी
aalochak	आलोचकक	आलोचक
alochak	अलोचकक	आलोचक
aalochakon	आलोचकों	आलोचकों
alochakon	अलोचकों	आलोचकों
aalha	आल्हा	आल्हा
aalhaa	आल्हा	आल्हा
alha	अल्हा	आल्हा
allah	अल्लाह	आल्हा
aawaazen	आवाजें	आवाज़ें
aawajen	आवाजें	आवाज़ें
awaazen	आवाजें	आवाज़ें
awazen	आवाजें	आवाज़ें
aawajon	आवाजों	आवाज़ों
aawazon	आवाजों	आवाज़ों
awaazon	आवाजों	आवाज़ों
awazon	आवाजों	आवाज़ों
aavishakaar	आविष्कार	आविष्कार
aavishkaar	आविष्कार	आविष्कार
avishkar	अविष्कार	आविष्कार
aavriti	आवृति	आवृत्ति
aavritti	आवृत्ति	आवृत्ति
avuti	अवृति	आवृत्ति
aavritiyon	आवृतियों	आवृत्तियों
aavrittiyon	आवृत्थियों	आवृत्तियों
avrutiyon	अवृतियों	आवृत्तियों
aashanka	आशंकका	आशंका
ashanka	आशंकका	आशंका
aashriton	आश्रितों	आश्रितों
ashriton	अश्रितों	आश्रितों
aasaan	आसान	आसान
aasan	आसनन	आसान
asan	असनन	आसान
aastik	आस्तिक	आस्तिक
astik	अस्तिक	आस्तिक
aasteen	आस्तिन	आस्तीन
aastin	आस्तिनों	आस्तीन
astin	एस्टिन	आस्तीन
aahnaan	आहननान	आह्नान
aahnan	आह्नान	आह्नान
ahyan	आह्वान	आह्नान
england	एंग्लैंड	इंग्लैंड
engineer	इंगीनियर	इंजिनियर
introduction	इंटरड््कशशन	इंट्रोडक्शन
insurance	इनस्रानसस	इंश्योरेंस
ear	इयर	इअर
eyer	आयर	इअर
eon	इयोन	इआन
iaan	आयान	इआन
ekattha	एकत्ठा	इकट्ठा
ikattha	इकत्ठा	इकट्ठा
ekatthi	एकट्थी	इकठ्ठी
ekthi	इक्ठी	इकठ्ठी
ikatthi	इकत्थी	इकठ्ठी
ekaee	एकाई	इकाई
ikai	इकाई	इकाई
ekaeyon	इकाइयों	इकाईयों
ikaiyon	इकाईयों	इकाईयों
ikarion	इकारियों	इकाईयों
economic	इकोनोमिक	इकोनोमिक
ecuador	एक्कीडेर	इक्वाडोर
equador	एक्यीडोर	इक्वाडोर
equities	एक्वीटीजसी	इक्विटीज
ikvitija	इक्तीमीज	इक्विटीज
ijaajat	इजाज़त	इजाजत
ijajat	इजाज़त	इजाजत
inhalation	इन्हालेेन	इनहेलेशन
inhaletion	इन्हेलेेन	इनहेलेशन
ibija	इबिज़	इबीजा
ibiza	इबिज़	इबीजा
imaging	इमाजिििं	इमेजिंग
immune	इम्यू	इम्युन
elaichi	इलाचीची	इलाइची
ilaichi	इलाचीची	इलाइची
ilayachi	इलायाची	इलाइची
ilayichi	इलायिची	इलाइची
elaaj	इलाज़	इलाज
ilaaj	इलाज़	इलाज
ilaj	इलाज़	इलाज
ishaak	इशाकक	इशाक
ishaaq	इशाकक	इशाक
ishak	इश्क	इशाक
ishaara	इशारा	इशारा
ishaaraa	इशारा	इशारा
ishara	इशारा	इशारा
ishita	इशिता	इशिता
isht	इश्ष	इष्ट
isteefe	इस्तीफे	इस्तीफे
istife	इस्टाइफ	इस्तीफे
ea	ईई	ईए
ia	आई	ईए
eater	एटर	ईटर
iter	इटरर	ईटर
email	एमेल	ईमेल
emailon	एमेलों	ईमेलों
emelon	एमेलों	ईमेलों
evening	एवेनिंग	ईवनिंग
east	ईस्ट	ईष्ट
ishat	इश्ट	ईष्ट
isht	इश्ष	ईष्ट
isaaiyon	ईसाइयों	ईसाइयों
isaiyon	इसाइयों	ईसाइयों
isayiyon	ईसाइयों	ईसाइयों
ikhrul	इकरुल	उखरुल
ukhrool	उखरूल	उखरुल
ukhrul	उखररुल	उखरुल
uchhalane	उछलनेे	उछालने
uchhalne	उछलनेे	उछालने
ujback	उजबेककक	उज़्बेक
uzbek	उबबेेक	उज़्बेक
uthane	उठाने	उठने
uthne	उठाने	उठने
uthaakar	उठाकर	उठाकर
uthakar	उठाकर	उठाकर
uthaapatak	उठापत्क	उठापटक
uthapatak	उठापत्क	उठापटक
uthen	उठाएं	उठें
udaan	उड़ान	उड़ान
udan	उड़ान	उड़ान
udaanaa	उड़नन	उड़ाना
udana	उड़ना	उड़ाना
udaane	उड़़ने	उड़ाने
udane	उड़ने	उड़ाने
udaanen	उड़नें	उड़ानें
udanen	उड़नें	उड़ानें
udaanon	उदानों	उड़ानों
udanon	उद़नों	उड़ानों
utane	उताने	उतने
utaney	उतनने	उतने
utne	उतने	उतने
uttara	उत्तर	उत्तरा
uttra	उत्तरर	उत्तरा
utpan	उत्पान	उत्पन
udant	उदांत	उदंत
udghosh	उद्घोष	उदघोष
udar	उदार	उदर
uda	उड़ा	उदा
udaa	उड़ा	उदा
udakishuganj	उद़कीकनंज	उदाकिशुनगंज
udakishunganj	उद़कीकनंजज	उदाकिशुनगंज
unatees	यननीती	उनतीस
untees	उनतीीस	उनतीस
uniyal	यूनियाल	उनियाल
upadraviyon	उपदार्वियों	उपद्रवियों
updravion	उपद्रियों	उपद्रवियों
updraviyon	उपद्रावियों	उपद्रवियों
upadravi	उपद्रवी	उपद्रवी
updravi	उपद्रवी	उपद्रवी
upadrawon	उपद्रवों	उपद्रवों
updravon	उपद्रवों	उपद्रवों
upneta	उपनेता	उपनेता
upabhokta	उपभोक्त	उपभोक्ता
upbhokta	उपभोक्त	उपभोक्ता
uplaksh	उपलाक्ष	उपलक्ष्य
uplakshay	उपललकषष	उपलक्ष्य
uplakshya	उपललकष्य	उपलक्ष्य
uplabdh	उपलब्ध	उपलब्ध
uplabdhiyon	उपलबादियों	उपलब्धियों
uplabdhi	उपलब्धी	उपलब्धी
upakhyaanon	उपखियानों	उपाख्यानों
upakhyanon	उपखियानों	उपाख्यानों
ubuntu	उबंतु	उबंटू
ubaal	उबाल	उबाल
ubal	उबलल	उबाल
ubhaara	उभारा	उभारा
ubhara	उभरा	उभारा
umanath	उमानाथ	उमानाथ
umesh	उमेेेश	उमेश
urf	उर्फ	उर्फ
urfa	उर्फा	उर्फ
urff	उर्फ	उर्फ
urvarakon	उर्वरकों	उर्वरकों
urvarkon	उरवार्कों	उर्वरकों
urwarakon	उर्वरकों	उर्वरकों
urvarata	उरवररता	उर्वरता
urvarta	उरवर्तता	उर्वरता
urwarta	उरवर्तता	उर्वरता
ulate	उलाते	उलटे
ulte	उल्टे	उलटे
ulahana	उलाहान	उलाहना
ulahna	उलाहन	उलाहना
ulema	उल्ेेमा	उलेमा
ulemaon	उल्मेमां	उलेमाओं
usak	उसकक	उसक
usaki	उसकी	उसकी
uski	उसकी	उसकी
usmein	उसमेें	उसमें
usmen	उसमें	उसमें
usi	उूसी	उसी
ustara	उस्तरा	उस्तरा
udharv	उदारवव	ऊर्ध्व
udhrva	उद्रवव	ऊर्ध्व
urdhav	उर्धवव	ऊर्ध्व
ushma	उष्म	ऊष्मा
rishicool	ऋशिकुक	ऋषिकुल
rishikul	ऋििकुकुल	ऋषिकुल
rushikul	ऋुिकुकुल	ऋषिकुल
enzyme	इनज्ाइम	एंजाइम
anton	एंटोन	एंटोन
entone	इंटोन	एंटोन
antoni	एंटोनी	एंटोनी
antony	एंटोनन	एंटोनी
endometrial	इंडोटेर्रिय	एंडोमेट्रियल
andreas	एंड्रीजस	एंड्रियास
als	अल्स	एएलएस
asi	असी	एएसआई
eksaath	एकसाथ	एकसाथ
eksath	एकस्थ	एकसाथ
ekaki	इकाीक	एकाकी
xm	क््म	एक्सएम
egmor	एगडोर	एगमोर
egmore	एगडोर	एगमोर
aj	अज़	एजे
agende	एजेंडे	एजेंडे
adp	एडपप	एडीपी
adain	अडानं	एडेन
aden	एडेन	एडेन
edan	एडनन	एडेन
addi	अडदी	एड्डी
eddi	एडडी	एड्डी
eddie	एडडी	एड्डी
eddy	एडडी	एड्डी
apj	अपज	एपीजे
ftii	फ्रीटी	एफटीआईआई
abbott	अब्बोट्ट	एबट
abut	अबूत	एबट
ebt	एब्ट	एबट
abvp	अब्पपप	एबीवीपी
abbot	अब्बोट	एबोट
abbott	अब्बोट्ट	एबोट
mta	मतता	एमटीए
mtake	मैकक	एमटेक
mtec	मेटेक	एमटेक
mtech	मेटेक	एमटेक
emerald	एमरल््	एमरल्ड
emrald	एमरल््	एमरल्ड
emil	एमिल	एमिल
emile	एमिल	एमिल
emily	एमिली	एमिल
amy	अम्य	एमी
emi	एमी	एमी
airway	एरवाय	एयरवे
eyarave	एयरवे	एयरवे
eyarve	एयरवे	एयरवे
error	एररो	एरर
arica	आरिका	एरिका
erica	एरिका	एरिका
erika	एरिका	एरिका
aerobic	एरोबिकिक	एरोबिक
aerobics	एररबॉक्स	एरोबिक
lte	ल्टे	एलटीई
lti	ल्टि	एलटीई
allergic	अलारिििक	एलर्जिक
eliminator	एलिलिनेटर	एलिमिनेटर
aliens	एलियंस	एलियंस
alliance	एलायनसस	एलियंस
asian	आशियां	एशियन
sfc	स्प््	एसएफसी
sk	स्क्	एसके
spf	स्प्फ	एसपीएफ
association	एसोसिएएशन	एसोसिएशन
astar	अस्तार	एस्टर
aster	एस्टर	एस्टर
ester	एस्टर	एस्टर
aesthetics	एस्थेटिक्क	एस्थेटिक
asthetic	अस्थेटिक	एस्थेटिक
asfalt	असफलत्ट	एस्फाल्ट
asphalt	अस्थात	एस्फाल्ट
asphault	असरफल्ट	एस्फाल्ट
ahsaas	अहसास	एहसास
ehsaas	हहसास	एहसास
ehsas	एहसास	एहसास
aisa	एसा	एेसा
eesa	ईसा	एेसा
ainth	ऐंठ	ऐंठ
end	इंड	ऐंठ
enth	ऐंठ	ऐंठ
ainthey	ऐंठे	ऐंठे
enthe	ऐंठे	ऐंठे
aithan	ऐंठन	ऐठन
ethan	ऐठनन	ऐठन
ethhan	ऐठठन	ऐठन
ail	एल	ऐल
el	इले	ऐल
alaps	अलाप्स	ऐल्प्स
alps	अल्प्स	ऐल्प्स
aise	एसे	ऐसे
oxide	ऑक्सिडड	ऑक्साइड
oxy	ओक्सी	ऑक्सी
offers	ऑफॉसर	ऑफर्स
offshor	ओफलसर	ऑफशोर
offshore	ओफलसोर	ऑफशोर
official	ओफिशिििल	ऑफिशियल
okalahoma	ओकालुमम	ओकलाहोमा
oklahoma	उकलाहुमा	ओकलाहोमा
oklahoma	उकलाहुमा	ओक्लाहोमा
ot	ओट	ओत
opel	ओपेल	ओपेल
obrayan	ओब्रययन	ओब्रायन
obrien	इब्रिनन	ओब्रायन
oran	ओरनन	ओरण
orian	ओरियान	ओरियन
orion	ओरियों	ओरियन
olavrishti	ओलाविष्टि	ओलावृष्टि
ovum	ओवुम	ओवम
owem	ओवेम	ओवम
oceanic	ओसीनिक	ओशनिक
osaka	ओसाका	ओसाका
auchity	औथिती	औचित्य
auchitya	औथित्य	औचित्य
audhyogikaran	औध्योगिकरण	औद्योगिकरण
audyogikarana	औग्यिगोकरण	औद्योगिकरण
audyogikikaran	औग्योगियोक्ण	औद्योगिकरण
aurangabad	औरगंबाड़	औरंगाबाद
aurora	औरोड़	औरोरा
aulakh	औलाख	औलख
kankad	कांकड़	कंकड़
kankar	कंककर	कंकड़
kankad	कांकड़	कंकर
kankar	कंककर	कंकर
kangan	कांगन	कंगन
conjunction	कंंकक्कनन	कंजंक्शन
contemporary	कंटंपररररर	कंटेम्पररी
kanthahar	कंठहरर	कंठहार
kanthhar	कंथरर	कंठहार
composer	कंपोसस	कंपोजर
kambalon	कंबबों	कंबलों
kanblon	कंबबों	कंबलों
consultant	कंसससटेंट	कंसलटेंट
kakkad	कक्कद	कक्कड़
kakkar	कक्कर	कक्कड़
kacche	कच्चे	कच्चे
kachche	कच्चे	कच्चे
karta	करता	कटरा
katra	कतर्	कटरा
cutlery	कटलरी	कटलरी
katlari	कटलतारी	कटलरी
katlary	कटटलर्	कटलरी
katasaraj	कत्सरााज	कटासराज
kathfodave	कटोफदेवे	कठफोड़वे
kathfodve	कठठद़्वे	कठफोड़वे
kathor	कथोर	कठोर
kathore	कथोरो	कठोर
kanika	कनिक	कणिका
kathai	कथाई	कत्थई
katthai	कट्थाई	कत्थई
katthaii	कट्थाई	कत्थई
convention	कॉव्वेशन	कनवेंशन
canals	कैनललस	कनाल
kanaal	कनाल	कनाल
kanal	कननल	कनाल
kanindham	कनिंधम	कनिंघम
kaningham	कानीघघम	कनिंघम
kanishthika	कनिष्ठिकत	कनिष्ठिका
kanishthikaa	कनिष्ठिकत	कनिष्ठिका
kanishtika	कनिष्टिक	कनिष्ठिका
kanyaayen	कन्याएं	कन्याएं
kanyaein	कन्याएं	कन्याएं
kanyayen	कन्ययएं	कन्याएं
convention	कॉव्वेशन	कन्वेंशन
convocation	कॉनोक्शशशन	कन्वोकेशन
cup	कूप	कप
kap	कपप	कप
kapda	कपड़ा	कपड़ा
kpada	कपाडा	कपड़ा
kapdo	कपड़ों	कपड़ो
kapdon	कपड़ों	कपड़ो
kaping	कैपिंग	कपिंग
kping	क्पिंग	कपिंग
kapolkalpana	कापलल्लपपनन	कपोलकल्पना
kabaddi	काबद्दी	कबड्डी
kabr	कबबर	कब्र
kabra	कबबरा	कब्र
kabren	कबरेेे	कब्रें
kabron	कबबरों	कब्रों
kamjor	कमजोर	कमज़ोर
kamzor	काजोोर	कमज़ोर
kamatar	कमातर	कमतर
kamtar	कममतर	कमतर
kalamjeet	कललामीत	कमलजीत
kamaljeet	कमलाीित	कमलजीत
kamaauu	कमाऊऊ	कमाऊ
kamau	कमाऊ	कमाऊ
kamaate	कमाते	कमाते
kamate	कमाते	कमाते
kamere	कमेरे	कमेरे
kmere	कममेर	कमेरे
karanj	करणंज	करंज
kranj	क्रंंज	करंज
karanjiya	करणजीय	करंजिया
kardhe	कर्धे	करघे
karghe	कार्घ	करघे
karachana	कराचन	करछना
karchhana	कर्चना	करछना
karna	कर्ण	करना
karpatri	करपतत्री	करपात्री
karam	कराम	करम
karoor	करूर	करूर
karur	करुर	करूर
karnataka	करणनतकका	कर्नाटका
karvi	कारववी	कर्वी
kurvi	कुर्वी	कर्वी
kalmein	कालमें	कलमें
kalmen	कालमें	कलमें
kalraj	कलरराज	कलराज
kalika	कालिका	कलिका
kalpanaon	कल्पनाओं	कल्पनाओं
kalpnaon	कल्पनाओं	कल्पनाओं
kavvaliyon	कववालियों	कव्वालियों
qawwaliyon	कववालियों	कव्वालियों
kavvali	कावववाली	कव्वाली
qawwali	कावववाली	कव्वाली
kashton	काष्टों	कष्टों
kasarat	कसरता	कसरत
kasrat	कसरत	कसरत
kasara	कसररा	कसारा
kasida	कसीदा	कसीदा
kahane	कहाने	कहने
kahne	कहने	कहने
kahlaya	कहलाया	कहलाया
kahaniyon	कहानियों	कहानियों
kile	कीले	क़िले
kanji	कांजी	कांजी
cant	कैंट	कांट
kant	कंटत	कांट
kanti	कंटी	कांति
kakoo	काकू	काकू
kaku	काकु	काकू
kaagaj	कागाज	कागज़
kaagaz	कागाज	कागज़
kagaj	कागाज	कागज़
kagaz	कागाज	कागज़
kaaji	काज़	काजी
kaji	काजी	काजी
kazi	काज़	काजी
qazi	काजी	काजी
kajoo	काजू	काजू
kaju	काजू	काजू
kapadi	कपा़ी	कापड़ी
kapdi	कपड़ी	कापड़ी
kamraj	कामराज	कामराज
kamottejana	काोतेकननन	कामोत्तेजना
kamottejna	काोटेकननन	कामोत्तेजना
kailana	कैलनन	कायलाना
kaylana	कायलनन	कायलाना
carfi	कार्फी	कार्की
karki	कर्की	कार्की
kartik	कार्तिक	कार्तिक
karyakartaon	कार्यक्रताओं	कार्यकर्ताओं
karykartaaon	कार्यक्रताओं	कार्यकर्ताओं
karykartaon	कार्यक्रताओं	कार्यकर्ताओं
karyabhar	कार्यभभर	कार्यभार
karybhar	कार्यभार	कार्यभार
karyarat	कार्यारत	कार्यरत
karyrat	कार्यार	कार्यरत
kaalpi	कालपपप	कालपी
kalapi	कलापपपी	कालपी
kalpi	कल्पपी	कालपी
kalika	कालिका	कालिका
kalighat	कालिघा	कालीघाट
coldvel	कॉडवेले	काल्डवेल
kaldvel	कल््वेे	काल्डवेल
kaldwell	काड्वेलल	काल्डवेल
kaav	काव	काव
kav	काव	काव
kaasht	काष्ट	काश्त
kasht	काष्ट	काश्त
kasim	कासीम	कासिम
qasim	कासीम	कासिम
kasimabad	काीमाबाद	कासिमाबाद
kiya	किया	किया
kiliyan	किलियां	किलियन
killat	किल्ला	किल्लत
killi	किल्ली	किल्ली
kisaani	किसानी	किसानी
kisani	किसनी	किसानी
kisanon	किसनों	किसानों
keede	कीद़	कीड़े
kide	कीड़े	कीड़े
keynote	केनोटो	कीनोट
kinote	किनोते	कीनोट
kiratpur	किरतपुुर	कीरतपुर
kundal	कुंडल	कुंडल
kundaliya	कुंडलिया	कुंडलियाँ
kundaliyan	कुंडलियां	कुंडलियाँ
kutta	कुट्टा	कुत्ता
kuposhit	कुपोषित	कुपोषित
kumau	कुमाऊ	कुमाऊ
kumavat	कुमावत	कुमावत
kumawat	कुमावत	कुमावत
kural	कुरलल	कुराल
kurmi	कुर्मी	कुर्मी
kursiyon	कुरससियों	कुर्सियों
kush	कुश	कुश
kushaan	कुशान	कुषाण
kushan	कुशान	कुषाण
kusumalataa	कुसुमलता	कुसुमलता
kusumalta	कुसुमलता	कुसुमलता
kusumlata	कुसुममता	कुसुमलता
koot	कूट	कूट
kut	कूट	कूट
kritika	क्रीकिका	कृतिका
kpo	कपपो	केपीओ
canterbari	कंटरबबरी	कैंटरबरी
canterbury	कैंरबरर	कैंटरबरी
candidate	कैंडीडेट	कैंडिडेट
katrina	कत्रीन	कैटरीना
caitlyn	कैटटिनन	कैटलिन
cateline	केटलाइन	कैटलिन
catlin	कैटलिन	कैटलिन
cadmium	कैड्यिमम	कैडमियम
catholic	कैथोलिक	कैथोलिक
catholicon	कैथोलिकों	कैथोलिकों
kaetholikon	कैथोलिकों	कैथोलिकों
capacitor	कैप्टेकरट	कैपेसिटर
carat	कररा	कैरेट
cavity	कैविती	कैविटी
cavalry	कैवलर्	कैवेलरी
kaivelari	कैवलवेर	कैवेलरी
complex	कंप््लेक्स	कॉम्प्लेक्स
kocchi	कोच्छी	कोच्चि
kochi	कोची	कोच्चि
corridor	कॉरिडोर	कोरिडोर
corolla	कोरोल्ला	कोरोला
korola	कोरोला	कोरोला
caolan	कॉलान	कोलन
colan	कोलन	कोलन
colon	कोलों	कोलन
calling	कॉलिंग	कोलिंग
koling	कोलिंग	कोलिंग
colorado	कलरोडों	कोलोराडो
kolorado	कोलोरोडो	कोलोराडो
kaushal	कौशाल	कौशल
kaushalata	कौशलाता	कौशलता
kaushalta	कौशल्ता	कौशलता
kaushambi	कौसंबी	कौशाम्बी
cute	कूट	क्यूट
quete	क्वीट	क्यूट
cube	क्बब	क्यूब
cubeck	कबबेक	क्यूबेक
quebec	क्वेबे	क्यूबेक
cubes	क्बेस	क्यूब्स
krantiyon	कृणत्तियों	क्रांतियों
cric	क्रिक	क्रिक
crick	क्रिक	क्रिक
cricket	क्रिककटट	क्रिकेट
cricketer	क्रिककेटर	क्रिकेटर
cricketing	क्रिक्टिंग	क्रिकेटिंग
kriyayog	क्रियययोग	क्रियायोग
christian	क्रिस्टियन	क्रिश्चयन
kruger	क्रूगर	क्रूगर
craig	क्रैग	क्रेग
creg	क्रेग	क्रेग
cradle	क्रेड्ल	क्रैडल
chrom	क्रोम	क्रोम
chrome	क्रोमी	क्रोम
client	क्लाइंं	क्लांइट
clock	क्लॉक	क्लाक
clasen	क्लेसें	क्लासें
classen	क्लेसेन	क्लासें
classon	क्लासों	क्लासों
clay	क्लाय	क्ले
claris	क्लारिज	क्लेरिस
cleris	क्लेरिस	क्लेरिस
clerys	क्लीर्स	क्लेरिस
quantico	क्वैंटिको	क्वांटिको
queens	क्विंस	क्वींस
kshitij	क्षीतीरी	क्षितिज
shitij	शीतीरीज	क्षितिज
kshin	क्षीन	क्षीण
shin	शीन	क्षीण
kshetron	क्षेत्रों	क्षेत्रों
shetron	क्षेत्रों	क्षेत्रों
khand	खाडड	खंडा
khanda	खांडा	खंडा
khachakhach	खखाचाच	खचाखच
khajarana	खजजरान	खजराना
khajraana	खजररान	खजराना
khajrana	खजजरान	खजराना
khatakati	खटककती	खटकती
khatakti	खटककी	खटकती
kihatkati	खिहटतति	खटकती
khattapan	खटत्टापन	खट्टापन
khat	खात	खत
khani	खानी	खनि
khanik	खानिक	खनिक
khanikarm	खानीकर्म	खनिकर्म
khanikarma	खानीकरमम	खनिकर्म
khanikarmi	खनीकर्ममी	खनिकर्म
khapat	खपपट	खपत
khariya	खरीया	खरिया
khalnayak	खाननायक	खलनायक
khaaskar	खाससकर	ख़ासकर
khaskar	खससकर	ख़ासकर
khaastaur	खाससौर	ख़ासतौर
khastaur	खासतौर	ख़ासतौर
khaibar	खैबरर	ख़ैबर
khyber	खेबरे	ख़ैबर
khaein	खाईएं	खाएं
khaen	खाएं	खाएं
khayen	खायेे	खाएं
khaate	खा़ते	खाते
khaatey	खातते	खाते
khate	खाते	खाते
khal	खाल	खाल
khinchakar	खिंचककर	खिंचकर
khinchkar	खींचकर	खिंचकर
khilana	खिलना	खिलाना
khinchkar	खींचकर	खींचकर
khuda	खुदा	खुदा
khudai	खुद़ाई	खुदाई
khurapka	खुरपक्ा	खुरपका
khurpaka	खुरपका	खुरपका
khurasan	खुरससन	खुरासान
khushiyan	खुशियां	खुशियां
khene	खेने	खेने
khaini	खाइनी	खैनी
khairati	खैरतती	खैराती
khoikhoi	खोखोोी	खोईखोई
khoya	खोया	खोया
gangrel	गंगग्रेल	गंगरेल
gangaajal	गंगाजजल	गंगाजल
gangajal	गंगजाज	गंगाजल
gandaki	गंदाकक	गंडकी
gandki	गंंडकी	गंडकी
gandh	गंं	गंध
gandha	गंंध	गंध
gae	गाई	गए
gaye	गाय	गए
gajara	गजजरा	गजरा
gajra	गजजर	गजरा
gadkar	गड़़कर	गडकर
ganapati	गणपती	गणपति
ganpati	गणपती	गणपति
gatisheel	गतिशीली	गतिशील
gatishil	गतिशिली	गतिशील
gatishilata	गतिशिलिता	गतिशीलता
gadadhar	गड्धार	गदाधर
gammat	गाममत	गम्मत
gaya	गाया	गया
garibi	गरीबी	गरीबी
garjana	गर्जनन	गर्जना
galgand	गगलगंं	गलगंड
gahmagahmi	गहममा्मम	गहमागहमी
gemhagehmi	जेहाज्जामी	गहमागहमी
ganguly	गंगगुली	गांगुली
gaanth	गांठ	गांठ
ganth	गंठ	गांठ
gaanthe	गंठठे	गांठे
ganthe	गंठे	गांठे
ganthen	गंठनें	गांठें
ganthon	गंठों	गांठों
gaen	गायन	गाएं
gayen	गायें	गाएं
gazi	गाजी	गाज़ी
gajipur	गाजीीपुर	गाजीपुर
gazipur	गाजीीपुर	गाजीपुर
gayatri	गायत्री	गायत्री
gayitri	गयित्री	गायत्री
gaytri	गायत्री	गायत्री
gidgidate	गिड़िड़ते	गिड़गिड़ाते
ginate	गिनते	गिनते
ginte	गिनटे	गिनते
girkar	गिरकार	गिरकर
girijaghar	गिरिजाघार	गिरजाघर
girjaghar	गिरजाघघर	गिरजाघर
girijagharon	गिरिजाघररों	गिरजाघरों
girjagharon	गिरजागारों	गिरजाघरों
girati	गिरतती	गिरती
girti	गिर्ती	गिरती
girish	गिरिश	गिरीश
guan	गुआन	गुआन
gujar	गुजरर	गुजार
gujarata	गुजरता	गुजारता
gujarta	गुजरता	गुजारता
gujarate	गुजराते	गुजारते
gujarte	गुजरते	गुजारते
gujarana	गुजरणन	गुजारना
gujarna	गुजरनन	गुजारना
gujara	गुजरा	गुजारा
gujare	गुजरे	गुजारे
gutta	गुट्टा	गुट्टा
gthalidar	ग्ाललिदार	गुठलीदार
guthalidar	गुथालिदार	गुठलीदार
gudna	गुडना	गुदना
gumaan	गुमान	गुमान
guman	गुमान	गुमान
gulshan	गुलशषन	गुलशन
gunga	गुंगा	गूंगा
grihnagar	गृहनागर	गृहनगर
gruhnagar	गृहनागर	गृहनगर
galaxion	गैलेक्सिं	गैलेक्सियों
galaxiyon	गालक्िियंं	गैलेक्सियों
galaxyon	गाल्क्यों	गैलेक्सियों
gochar	गोचार	गोचर
gouchar	गोचार	गोचर
godara	गोडारा	गोदारा
gopichand	गोपीचंद	गोपीचंद
gomake	गोमककक	गोमके
gomke	गोमके	गोमके
goel	गोलल	गोयल
goyal	गोयलल	गोयल
gosvaami	गोस्वामी	गोस्वामी
gosvami	गोस्वामी	गोस्वामी
goswami	गोस्वामी	गोस्वामी
gaumukh	गौमुख	गौमुख
gomukh	गोमुख	गौमुख
gaumutr	गौमुत्र	गौमूत्र
gaumutra	गुुमत्र	गौमूत्र
gowmutra	गोंमुत्र	गौमूत्र
granthiyaan	ग्रंटियां	ग्रंथियां
granthiyan	ग्रंटियां	ग्रंथियां
grandhiyon	ग्रांधियों	ग्रंथियों
granthiyon	ग्रंथियों	ग्रंथियों
greest	ग्रीस्ट	ग्रीस्ट
greist	ग्रेस्ट	ग्रीस्ट
grist	ग्रिस्ट	ग्रीस्ट
greg	ग्रेग	ग्रेग
granite	ग्रेनिट	ग्रेनाइट
grenite	ग्रेनीट	ग्रेनाइट
grandson	ग्रैंड्सों	ग्रैंडसन
gross	ग्रॉस्स	ग्रॉस
ghataatop	घटटतोपो	घटाटोप
ghatatop	घटटतोपप	घटाटोप
ghataayaa	घटाया	घटाया
ghataya	घटाया	घटाया
ghanakar	घननकर	घनाकार
ghabrahat	घब्रहह	घबराहट
ghasi	घासी	घासी
ghisai	घिसाई	घिसाई
ghisi	घिसीसी	घिसी
ghise	घिसे	घिसे
ghumakkadi	घुमकककदी	घुमक्कड़ी
ghumakkdi	घुमकक्ीी	घुमक्कड़ी
ghumakkadon	घुमकककदों	घुमक्कड़ों
ghumakkaron	घुमक्कारों	घुमक्कड़ों
ghumakkdon	घुमकक्दों	घुमक्कड़ों
ghummakkadon	घूमक्ककाोों	घुमक्कड़ों
ghumaan	घुमान	घुमाण
ghuman	घुमान	घुमाण
ghoonsa	घूंसा	घूंसा
ghunsa	घुंसा	घूंसा
ghongha	घोंघा	घोंघा
ghontane	घोंटनेे	घोंटने
ghontne	घोंटने	घोंटने
ghot	घोटत	घोट
ghodi	घोड़ी	घोड़ी
ghost	घोस्ट	घोस्ट
changul	चांगुल	चंगुल
chand	चांड	चंद
chandan	चांदन	चंदन
chandana	चांदना	चंदन
chandu	चाददू	चंदू
chandon	चांडों	चंदों
chandrabali	चंद्रबील	चंद्रबली
chandramaon	चंद्रमाओं	चंद्रमाओं
chakatte	चकत्त	चकत्ते
chaktte	चक्ते	चकत्ते
chakkar	चक्कर	चक्कर
chkkar	च्ककर	चक्कर
chakshu	चक्षु	चक्षु
chatagaon	चतागाओं	चटगांव
chatgaon	चटगााां	चटगांव
chadhane	चढ़ने	चढ़ने
chadhne	चढ़ने	चढ़ने
chaturdik	चातुर्दिक	चतुर्दिक
chatunshkoniy	चटुसकंकियों	चतुष्कोणीय
chatushkoniy	चतुट्षोकीय	चतुष्कोणीय
chatushkoniya	चतुट्षोकिय	चतुष्कोणीय
channa	चानना	चन्ना
chabate	चबबते	चबाते
chabutare	चाबूतार	चबूतरे
chabutre	चाबूत्रे	चबूतरे
chamakna	चमकनन	चमकना
chamkana	चमकनन	चमकना
charas	चररस	चरस
charit	चररित	चरित
charcha	चर्चा	चर्चा
churcha	चर्चा	चर्चा
charchaon	चर्चाओं	चर्चाओं
chalenge	चालेंगे	चलेंगे
chlenge	च्लेंगे	चलेंगे
chahunaur	चौूूनार	चहुंओर
chahunor	चाूूनोर	चहुंओर
chanval	चावलाल	चांवल
chanwal	चावलाल	चांवल
chachaji	चाजीी	चाचाजी
chadar	चादार	चादर
chadaron	चददररों	चादरों
chadron	चददरों	चादरों
chan	चान	चान
chanan	चानन	चानन
chaplusi	फापललससी	चापलूसी
chayal	चययल	चायल
char	चरर	चार
charon	चररों	चारों
charge	चार्ज	चार्ज
chart	चर्त	चार्ट
charton	चर्तों	चार्टों
charts	चार्ट्स	चार्ट्स
chaalit	चालित	चालित
chalit	चलित	चालित
chikitsak	चिकित्सकक	चिकित्सक
chikitsakon	चिकित्सकों	चिकित्सकों
chikhali	चिखली	चिखली
chiththi	चित्ठी	चिट्ठी
chitthi	चित्थी	चिट्ठी
chithhi	चित्ही	चिठ्ठी
chiththi	चित्ठी	चिठ्ठी
chitthi	चित्थी	चिठ्ठी
chidchidapan	चिड़चिड़ापन	चिडचिडापन
chidchidapan	चिड़चिड़ापन	चिड़चिड़ापन
chidhate	चिढ़ते	चिढ़ते
chidhte	चिड़ते	चिढ़ते
chithrkar	चित्रकरर	चित्रकार
chitrkar	चित्रककर	चित्रकार
chipakane	चिपकनन	चिपकने
chipakne	चिपकने	चिपकने
chipkane	चिपकाने	चिपकने
chimati	चिमटती	चिमटी
chimti	चिमती	चिमटी
chillane	चिल्ने	चिल्लाने
chee	ची	ची
chi	चीई	ची
chuka	चुका	चुका
chune	चूने	चुने
chunar	चुनरर	चूनर
changed	चांगेेड	चेंज्ड
chetti	चेत्टी	चेट्टी
chennai	चेनेना	चेन्नई
chero	चेरो	चेरो
chest	चेस्ट्ट	चेस्ट
championship	चैंपिंशशपप	चैंपियनशिप
chor	चोरर	चोर
choro	चोरोो	चोरों
choron	चोरों	चोरों
chauk	चौकक	चौक
chowk	चोंक	चौक
chauka	चौका	चौका
chuka	चुका	चौका
chaukiyan	चौकियां	चौकियां
chauki	चौकी	चौकी
chaukhate	चौखते	चौखटे
chauguni	चौगुधी	चौगुनी
chauda	चौड़ा	चौड़ा
chaudah	चौदाह	चौड़ा
chaudahavan	चौठहवान	चौदहवां
chaudhavan	चौधववनन	चौदहवां
chaudhawan	चौधववनन	चौदहवां
chaupati	चौपाती	चौपाटी
chupaty	चुपटती	चौपाटी
chaupal	चौपाल	चौपाल
chaurai	चौराई	चौरई
chausinga	चौसिंगा	चौसिंगा
chausingha	चौसिंगा	चौसिंगा
chhagan	छागन	छगन
chhabi	छाबी	छबि
chhalla	छल्ला	छल्ला
chhallaa	छल्ला	छल्ला
chhaviyaan	छावियां	छवियाँ
chhaviyan	छावियां	छवियाँ
chhavi	छावी	छवी
cheh	चेह	छह
chhah	छाह	छह
chehon	चेहों	छहों
chhahon	छाहों	छहों
chhai	छाई	छाई
chhagla	छगगा	छागला
chhajan	छाजन	छाजन
chhaati	छाटी	छाती
chhati	छटी	छाती
chhaapemaar	छापेमार	छापेमार
chhapemar	छापेमार	छापेमार
chheenk	छींक	छींक
chhink	छींक	छींक
chink	चिंक	छींक
chenkein	चेंकें	छींके
chhekein	छेकें	छींके
chhinke	छिंके	छींके
chhinky	छिंककी	छींके
chinke	चिंके	छींके
chhudaane	छुड़ाने	छुडाने
chhudane	छुड़ाने	छुडाने
chhupakar	छुपाकर	छुपकर
chhupkar	छुपककर	छुपकर
chhupkr	छुपककर	छुपकर
chhupata	छुपटता	छुपता
chhupta	छुपटा	छुपता
chhuptaa	छुपटा	छुपता
chhura	छुररा	छुरा
chhuraa	छुराा	छुरा
chhuree	छुरी	छुरी
chhuri	छुररी	छुरी
chhure	छुरर	छुरे
chhootane	छूटनेे	छूटने
chhutane	छुटनने	छूटने
chhutne	छूटने	छूटने
chheter	छित्र	छेत्र
chhetr	छेत्तर	छेत्र
chhetter	छेत्तर	छेत्र
chhetri	छेत्तीरी	छेत्री
chhetthari	छेत्रहरी	छेत्री
chhetthri	छेत्तररी	छेत्री
chai	चैई	छै
chhai	छाई	छै
chhe	छे	छै
jagaega	जगाेगा	जगाएगा
jagayega	जगाेगा	जगाएगा
jaghaega	जाहेगगा	जगाएगा
jgaayega	जगाएगा	जगाएगा
jgayegaa	जगगेगा	जगाएगा
jajaon	जजाांं	जजों
jajon	जाजोंं	जजों
jad	जडद	जड़
jadd	जड्द	जड़
jaddit	जडडिित	जड़ित
jadeite	जडेेत	जड़ित
jadet	जादेत	जड़ित
jadit	जड़ित	जड़ित
jadein	जड़ें	जड़ें
jaden	जड़ें	जड़ें
jatara	जतारा	जतरा
jatra	जततर	जतरा
jataati	जताती	जताती
jatatee	जताती	जताती
jatati	जताती	जताती
janagananaa	जननाननन	जनगणना
janaganna	जननग्नन	जनगणना
jangadnaa	जागगदनन	जनगणना
janganana	जंगानन	जनगणना
janganna	जंगनननन	जनगणना
janajagran	जनजाग्रण	जनजागरण
janjaagran	जनजाग्रण	जनजागरण
janjagran	जनजाग्रण	जनजागरण
january	जनुूर्य	जनवरी
janahaani	जनाहानी	जनहानि
janahani	जनाहानी	जनहानि
janhaani	जनहानी	जनहानि
janhani	जनहहनी	जनहानि
jnhaani	जनहानी	जनहानि
jamaate	जमाते	जमाती
jamaati	जमाती	जमाती
jamati	जमाती	जमाती
jamaaya	जमाया	जमाया
jamaeya	जमाया	जमाया
jamaya	जमाया	जमाया
jamayaa	जमाया	जमाया
jamuai	जमुआईई	जमुई
jamuei	जमुईई	जमुई
jamui	जमुईई	जमुई
jai	जैई	जय
jay	जाय	जय
jaidayal	जैदयाल	जयदयाल
jayadayal	जययायल	जयदयाल
jaydayal	जाययाल	जयदयाल
jaibaan	जयबान	जयबाण
jaiban	जैबान	जयबाण
jaybaan	जयबान	जयबाण
jayalalita	जयललिता	जयललिता
jayalalitaa	जयललिता	जयललिता
jayalalithaa	जयलालिता	जयललिता
jaylalita	जयललिता	जयललिता
jarakh	जररख	जरख
zarakh	जररख	जरख
jarda	जरदा	जर्दा
jardaa	जरदाा	जर्दा
zarda	जरदाा	जर्दा
jalagati	जलाती	जलगति
jalgati	जलगती	जलगति
jalgti	जललती	जलगति
jalte	जलते	जलते
jalbharav	जलभारव	जलभराव
jalbhraav	जलभररव	जलभराव
jalbhrav	जलभरवा	जलभराव
jalvaayu	जलवायु	जलवायु
jalvayu	जलवायु	जलवायु
jalesar	जलेसर	जलेसर
jasmeet	जसमीत	जसमीत
jasmit	जस्मित	जसमीत
jassee	जससीी	जस्सी
jassi	जसससी	जस्सी
jamaanaa	जमाना	ज़माना
jamana	जमाना	ज़माना
zamaanaa	जमानन	ज़माना
zamana	जमानन	ज़माना
jaljale	जल्लेल	ज़लज़ले
zalzale	ज़्लाल	ज़लज़ले
zee	जी	ज़ी
jubaan	जुबान	ज़ुबान
juban	जुबान	ज़ुबान
zuban	जुबान	ज़ुबान
jaanch	जांच	जाँच
jaaunch	जौउचच	जाँच
janch	जांच	जाँच
jaunch	जौंच	जाँच
jaagriti	जागृति	जागृति
jagriti	जगगृति	जागृति
jagruti	जगगृति	जागृति
jajamau	जजममौ	जाजमऊ
jajmau	जजममू	जाजमऊ
jajmauu	जजममू	जाजमऊ
jaat	जात	जात
jat	जतत	जात
jaatak	जातक	जातक
jatak	जटाक	जातक
jaatakon	जातकों	जातकों
jaatkon	जातकों	जातकों
jatakon	जताकों	जातकों
jaatiyon	जातियों	जातियों
jatiyon	जातियों	जातियों
jaankaaron	जानकारों	जानकारों
jaankaron	जानकारों	जानकारों
jankaron	जानकररों	जानकारों
jaanam	जानम	जानम
janam	जन्म	जानम
jaayke	जायके	जायके
jayke	जायके	जायके
jaawar	जावरर	जावर
zawar	जववर	जावर
jing	जिंग	जिंग
gin	गीन	जिन
jeen	जीन	जिन
jin	जीन	जिन
ginee	गिनी	जिनी
jinee	जीनी	जिनी
jini	जीनी	जिनी
geneva	जेनेवा	जिनीवा
jeneva	जेनेवा	जिनीवा
jiniva	जीनीव	जिनीवा
gypsy	गिपप्सी	जिप्सी
jimme	जिम्मे	जिम्मे
jiya	जीया	जिया
gic	गिक्स	जीआईसी
gr	ग्रा	जीआर
gm	जीम	जीएम
gsm	जिस्म	जीएसएम
gtod	ग्तोड़	जीतोड़
gtor	ग्टोर	जीतोड़
jeetod	जीतोरो	जीतोड़
jitod	जितोऱ	जीतोड़
jean	जीन	जीन
jeen	जीन	जीन
jin	जीन	जीन
jeenon	जीनों	जीनों
jinon	जीनों	जीनों
jeepney	जीपने	जीपनी
jipani	जीपानी	जीपनी
jeeyo	जीयों	जीयो
jio	जियो	जीयो
jiyo	जीयों	जीयो
jeera	जीरा	जीरा
jira	जिरा	जीरा
jeevant	जीवंत	जीवंत
jivant	जीवंत	जीवंत
jeevan	जीवनन	जीवन
jeewan	जीवनन	जीवन
jivan	जीवनन	जीवन
jiwan	जीवनन	जीवन
jeevanshaili	जीवनशाली	जीवनशैली
jivanshaili	जीवनशाली	जीवनशैली
jeevniyaan	जीववियां	जीवनियां
jivaniya	जीवनिया	जीवनियां
jivaniyaan	जीवनियां	जीवनियां
jivaniyan	जीवनियां	जीवनियां
jeevraaj	जीवराज	जीवराज
jivraj	जिवराज	जीवराज
jua	जुआ	जुए
jue	जुआ	जुए
juye	जुए	जुए
jutee	जुटी	जुटी
juti	जुती	जुटी
judaai	जुडाईई	जुड़ाई
judae	जुड़ा	जुड़ाई
judai	जुड़ई	जुड़ाई
judaai	जुडाईई	जुदाई
judai	जुड़ई	जुदाई
junoon	जुनूओं	जुनून
junun	जुनुन	जुनून
junooni	जुनूनी	जुनूनी
jununi	जुनानी	जुनूनी
jubair	जुबैर	जुबेर
juber	जुबेर	जुबेर
zubair	जुबबैर	जुबेर
juraab	जुराब	जुराब
jurab	जुराब	जुराब
julaahon	जुलाहों	जुलाहों
julahon	जुलाहों	जुलाहों
julmon	जुल्मों	जुल्मों
zulmon	जुल्मों	जुल्मों
jood	जूड	जूड
jud	जुड	जूड
junagadh	जुनागढ़	जूनागढ
junagarh	जुनागढ़	जूनागढ
junior	जुनियर	जूनियर
jealous	जीलॉस	जूलूस
juloos	जुलूस	जूलूस
julus	जुलुस	जूलूस
jetha	जेठा	जेठा
jenner	जेन्र	जेनर
generic	जेनेरिक	जेनरिक
jenrick	जैनरिक	जेनरिक
generat	जनररर	जेनरेट
generate	जनरेेट	जेनरेट
jenee	जेनी	जेनी
jenni	जेन्नी	जेनी
jenny	जेन्न	जेनी
james	जमेस	जेम्स
jeremy	जेरेमी	जेरेमी
gerome	गेरोम	जेरोम
jerome	जेरोमम	जेरोम
jacks	जैक्स	जैक्स
jain	जैन	जैन
gene	गेने	जैने
jaine	जानेे	जैने
jaino	जैनों	जैनों
jainon	जैनों	जैनों
jerry	जेरर	जैरी
jasper	जससेर	जैस्पर
jogging	जॉगिंगग	जॉगिंग
johnson	जॉनससन	जॉनसन
jobs	जॉब्स	जॉब्स
jockey	जॉकक	जोकि
joki	जोकी	जोकि
jokhim	जोखिम	जोखिम
joddta	जोड़तता	जोड़ता
jodta	जोड़ता	जोड़ता
jorhta	जोड़ता	जोड़ता
jodiyon	जोड़ियों	जोड़ियों
jodo	जोड़ों	जोड़ो
jaun	जौन	जौं
gyatavya	ज्यातव्व	ज्ञातव्य
gyatvy	ज्ञात्वय	ज्ञातव्य
gyapit	ज्ञापित	ज्ञापित
jyotiba	ज्योतिबा	ज्योतिबा
joint	जॉयंट	ज्वाइंट
jvar	ज्वर	ज्वार
jwar	ज्वर	ज्वार
jvaaron	जवारों	ज्वारों
jvaron	जववरों	ज्वारों
jwaron	ज्वरों	ज्वारों
jewellers	ज्वेलर्स	ज्वेलर्स
jh	झू	झ
jha	झा	झ
jhalakti	झलकती	झलकती
jhalkati	झलकती	झलकती
jhalla	झल्ला	झल्ला
jhankana	झांकन	झांकना
jhankna	झांकन	झांकना
jheel	झील	झील
jhil	झीले	झील
jheelon	झीलों	झीलों
jhilon	झीलों	झीलों
jhuthala	झूठला	झुठला
jhuthla	झूठला	झुठला
jhuthalane	झूठलने	झुठलाने
jhuthlane	झूठलने	झुठलाने
tankaar	टंककर	टंकार
tankar	टंककर	टंकार
takara	टाकरा	टकरा
takra	टाकरा	टकरा
takaraon	टकरकाओं	टकरावों
takravon	तकरावों	टकरावों
tapakti	तपक्ति	टपकती
tapkati	तपककती	टपकती
time	टाइम	टाइम
timer	टाइमर	टाइमर
taoo	ताऊू	टाऊ
tau	ताउ	टाऊ
tapoowo	तपूपों	टापुओं
tapuon	तपुुंं	टापुओं
tapuwo	तापुरों	टापुओं
tied	टीयड	टायर्ड
tired	तिरेड	टायर्ड
tyred	टायरेड	टायर्ड
tarch	तर्चच	टार्च
torch	टॉर्च	टार्च
tik	टीक	टिक
teap	टीपे	टिप
tip	टीप्	टिप
tippanikar	तिप्पांकार	टिप्पणीकार
tippnikar	तिप्पनीकार	टिप्पणीकार
tivolee	तिवोली	टिवोली
tivoli	तिविलो	टिवोली
teekamgarh	तीकागढढ़	टीकमगढ़
tikamgarh	तिकागढढ़	टीकमगढ़
teekon	टीकों	टीकों
tikon	टीकों	टीकों
two	ट्वों	टु
tension	टेंशनन	टेंशन
tenis	टेनिस	टेनिस
tennis	टेनिन	टेनिस
taste	तस्ते	टेस्ट
test	टेस्ट	टेस्ट
tasting	तास्टिंग	टेस्टिंग
testing	टेस्टिंग	टेस्टिंग
tainin	तैनिनों	टैनिन
tenin	टेनिन	टैनिन
tanish	तैनिश	टैनिस
tennis	टेनिन	टैनिस
taboo	तबबू	टैबू
taiboo	टैबबू	टैबू
taobao	ताबबा	टैबू
tonic	टॉनिक	टॉनिक
tonga	टोंगा	टोंगा
toka	टोका	टोका
tuesday	टुसेदा	ट्यूजडे
tuning	ट्नूजिंग	ट्यूनिंग
tuberculosis	टाबबुजुयॉसिसस	ट्यूबरक्यूलोसिस
tuberkyulosis	टेब्युु्यकिसिज	ट्यूबरक्यूलोसिस
truck	ट्रिक	ट्रक
trangistor	ट्रैंगिस्टर	ट्रांजिस्टर
tranjister	ट्रांजिस्टर	ट्रांजिस्टर
transistor	ट्रांसेस्टर	ट्रांजिस्टर
transfer	ट्रांसफेर	ट्रान्सफर
tribunal	ट्रिबिमनल	ट्रिब्युनल
tribunal	ट्रिबिमनल	ट्रिब्यूनल
trubyunal	ट्रिब्यमनन	ट्रिब्यूनल
truth	त्रुथ	ट्रुथ
tuth	टूथ	ट्रुथ
traded	ट्रेड्	ट्रेडेड
trabal	ट्रबब	ट्रेबल
trebal	ट्रेबल	ट्रेबल
trouble	ट्रूबल	ट्रेबल
traip	ट्रैपप	ट्रैप
trap	ट्राप	ट्रैप
trot	त्रोत	ट्रॉट
trott	ट्रोट्ट	ट्रॉट
thakkar	थक्कर	ठक्कर
thakkr	थक्कर	ठक्कर
thaharne	ठहराने	ठहरने
thahrane	ठहराने	ठहरने
theharne	ठहरनने	ठहरने
thikane	ठिकाने	ठिकाने
thumari	थुमारी	ठुमरी
thumri	थूमरी	ठुमरी
theinga	थींगा	ठेंगा
thenga	ठेंगा	ठेंगा
thengaa	ठेंगा	ठेंगा
daglas	दगलसस	डगलस
douglas	डॉगलास	डगलस
dabhara	दभभरा	डभरा
dabhra	दभभर	डभरा
dabhoi	दभभो	डभोई
dam	डाम	डम
dum	डूम	डम
darate	दरतत	डराते
daratey	दरतत	डराते
daravani	दरवावीण	डरावनी
darawani	दरवावनी	डरावनी
dravani	द्रवणी	डरावनी
down	डानों	डाउन
daak	डाक	डाक
dak	डाक	डाक
daka	डकक	डाका
dabi	डबी	डाबी
dabolim	डबोललि	डाबोलिम
dinosaur	डिनोससर	डायनासोर
diaries	डायरीज	डायरीज
dit	डित	डिट
depthiriya	देप्थिरिय	डिप्थीरिया
diphtheria	दिथ्रेरिया	डिप्थीरिया
de	डे	डीई
dealership	डेलेरशिप	डीलरशिप
dvc	ड्वीक	डीवीसी
dubaana	दुबाना	डुबाना
dubana	दुबना	डुबाना
dubona	डुबोना	डुबोना
dulne	दुलने	डुलने
doonarpur	दुणरापुर	डूंगरपुर
doongarpur	दुंगापुर	डूंगरपुर
dungarpur	दुंगापुर	डूंगरपुर
dungerpur	डंंगरपुर	डूंगरपुर
dubana	दुबना	डूबना
dubna	डूबना	डूबना
dangerous	डैंगरेज	डेंजरस
daisy	डैस्य	डेजी
dazy	डज््	डेजी
deji	देजी	डेजी
deputy	डिप्टी	डेप्युटी
davidson	दिविडसों	डेविडसन
devidson	डिविडनस	डेविडसन
davey	देवे	डेवी
devi	देवी	डेवी
dewey	देवे	डेवी
destination	डेस्टीनेशन	डेस्टिनेशन
datson	दत्सों	डैटसन
datsun	दत्सुन	डैटसन
daddy	दद्दीय	डैडी
dark	डार्क	डॉर्क
dork	डोर्क	डॉर्क
dose	डोस	डोज
domenic	डोमेनिक	डोमेनिक
doranda	दौरंंड	डोरंडा
dolane	डोलाने	डोलने
dolne	डोलने	डोलने
dual	डुआल	ड्युअल
duak	दुकक	ड्यूक
duke	डुके	ड्यूक
drame	ड्रेम	ड्रामे
dramen	ड्रेमेन	ड्रामे
drager	ड्रेगर	ड्रेजर
dredger	ड्रेडर	ड्रेजर
dreijer	ड्रीजर	ड्रेजर
dhakaal	धकालल	ढकाल
dhakal	धकाल	ढकाल
dhakkal	धक्ककल	ढकाल
dhkal	धकाल	ढकाल
dhale	ढाले	ढले
dhoondh	धूंध	ढूंढ
dhundh	धूंध	ढूंढ
dhoondhata	धूंधता	ढूंढता
dhundhata	धूंधता	ढूंढता
dhundhta	धूंधता	ढूंढता
dhoondhi	धूंधी	ढूंढी
dhundhi	धूंधी	ढूंढी
tanjavur	तंजावुर	तंजावुर
thanjavur	तंजावुर	तंजावुर
tantr	तंत्र	तंत्र
tantra	तंत्र	तंत्र
tantrikao	तात्रिककाां	तंत्रिकाओं
tantrikaon	तंत्रिककाओं	तंत्रिकाओं
tantro	तंत्ोर	तंत्रों
tantron	तंत्रों	तंत्रों
tagade	तगड़े	तगड़े
tagde	ताड़े	तगड़े
tadipaar	ता़ीपार	तड़ीपार
tadipar	तादीपरर	तड़ीपार
tani	तानी	तनी
tapan	तापान	तपन
tarafa	तररफा	तरफा
tarfa	तररफा	तरफा
tarabganj	तरबबगंज	तरबगंज
taras	तररस	तरस
taraash	तराश	तराश
tarash	तराश	तराश
tarashay	तराशाय	तराशे
tarashe	तराशे	तराशे
tareeko	तरीकों	तरीको
tariko	तरीकों	तरीको
tark	तार्क	तर्क
tarkvaad	तर्कवाद	तर्कवाद
tarkvad	तर्कवाद	तर्कवाद
tarkwaad	तर्कवाद	तर्कवाद
tarko	तार्कों	तर्कों
tarkon	तार्कों	तर्कों
talabgaar	तललागार	तलबगार
talabgar	तललागरर	तलबगार
talbagaar	तललागरर	तलबगार
talbagar	तललागर	तलबगार
talawe	तलवाे	तलवे
talve	तलवे	तलवे
talawon	टलवाोों	तलवों
talvon	तलव्ंों	तलवों
tahakhana	तहखखन	तहखाना
tahkhaana	तहखाना	तहखाना
tahkhana	तहखखनन	तहखाना
taantaa	तांता	तांता
tanta	तांटा	तांता
tambe	तंबबे	तांबे
tanbe	तंबेे	तांबे
taaja	ताजा	ताजा
taajaa	ताजा	ताजा
taaza	ताज़ा	ताजा
taja	ताजा	ताजा
taza	ताजा	ताजा
tansen	टांसें	तानसेन
taapmaanon	ताममानों	तापमानों
tapmano	ता्मानों	तापमानों
tapmanon	ता्मानों	तापमानों
taapti	तापती	ताप्ती
tapti	तप््ति	ताप्ती
tarabai	तरबाब	ताराबाई
taseer	तसीर	तासीर
tasir	तसीर	तासीर
taahi	ताह़	ताहि
tahi	ताही	ताहि
tikone	टिकोन	तिकोने
tirupati	तिरुपति	तिरूपति
tiwari	तिवारी	तिवारी
ti	ती	ती
teer	तीरर	तीर
tir	तीर	तीर
teeron	तीरों	तीरों
tiron	तिरों	तीरों
tirthatan	तीर्थतनन	तीर्थाटन
tungnath	टंंगता	तुंगनाथ
tughlaq	तुगलाक	तुगलक
tuglak	तुगगाक	तुगलक
tughlakabad	तुल्ललाबा	तुगलकाबाद
tughlaqabad	तुल्ललाबा	तुगलकाबाद
tuglakabad	तुलगकााबा	तुगलकाबाद
tugalaki	तुगगाकी	तुगलकी
tugalki	तुगगलकी	तुगलकी
tuglaki	तुगगाकी	तुगलकी
tufail	टुफफेल	तुफैल
tejaji	तेजाजी	तेजाजी
teji	तेजी	तेजी
tel	टेल	तेल
telon	टेलों	तेलों
to	टो	तो
toh	तोह	तो
taul	टॉउल	तौल
tyohaar	त्योहार	त्यौहार
tyohar	त्योहार	त्यौहार
tyoihar	त्योहार	त्यौहार
tyauharon	त्याहारों	त्यौहारों
tyoharon	त्योहारों	त्यौहारों
tyoiharon	त्योहारों	त्यौहारों
trijata	त्रीजता	त्रिजटा
trijta	त्रीजता	त्रिजटा
triya	त्रिया	त्रिया
tremasik	ट्रेमेसिक	त्रैमासिक
trimasik	त्रिमासिक	त्रैमासिक
tse	ट्से	त्से
thaki	ठाकी	थकी
thki	थककी	थकी
tharti	थारती	थर्टी
thirty	थीरती	थर्टी
thane	ठाने	थाणे
thaanvi	ठानवी	थानवी
thanvi	ठानवी	थानवी
theateron	थीटेरों	थिएटरों
theatron	थीत्ररों	थिएटरों
theaters	थीटर्स	थिएटर्स
theater	थीटर	थियेटर
theatre	थीतर्र	थियेटर
theateron	थीटेरों	थियेटरों
theatron	थीत्ररों	थियेटरों
thitron	थित्रों	थियेटरों
theaters	थीटर्स	थियेटर्स
theatrs	थ्टर्र्स	थियेटर्स
thiyeters	थिय्टर्स	थियेटर्स
thirake	थिरके	थिरके
thirke	थिरके	थिरके
thief	थीफ	थीफ
then	ठेन	थेन
theni	थेनी	थेनी
thailee	थैली	थैली
thaili	थैली	थैली
thaile	थैले	थैले
dang	डांग	दंग
danga	डांगा	दंगा
dangon	डांगों	दंगों
dampati	दापपती	दंपति
danpati	दानपती	दंपति
dampatiyon	दंप्तियों	दंपतियों
dampattiyon	दंपत्तियों	दंपतियों
danptiyon	दापत्तियों	दंपतियों
dadreva	दद्रेव	ददरेवा
dadrewa	दद्रेवा	ददरेवा
damoh	डममो	दमोह
dardara	दरदारा	दरदरा
dardraa	दर्दरर	दरदरा
durdhara	दुर्धरा	दरदरा
darmiyaan	दर्मियां	दरमियान
darmiyan	दर्मियां	दरमियान
darjano	दर्जनों	दर्जनों
darjanon	दर्जनों	दर्जनों
darp	दर्पप	दर्प
darra	दररर	दर्रा
dalbadal	दबदलदाल	दलबदल
dalbadl	दबदब्ल	दलबदल
dali	डली	दली
dastaanaa	दस्ताना	दस्ताना
dastana	दास्तनन	दस्ताना
dastavej	दस्तावेज	दस्तावेज
dahan	दानन	दहन
dahal	दहाल	दहल
da	डा	दा
daakhil	दाख़ील	दाखिल
dakhil	दाखीील	दाखिल
daakhile	दाख़ील	दाखिले
dakhile	दाखीले	दाखिले
daataa	दाता	दाता
data	दाता	दाता
dadari	दददरी	दादरी
daanshil	दांशील	दानशील
danshil	दंशील	दानशील
daabholkar	दाभोलककर	दाभोलकर
dabholkar	दाबोलका	दाभोलकर
damale	डमले	दामले
damle	डमले	दामले
dayitv	दययित्व	दायित्व
dayitva	दययित्व	दायित्व
dayitwa	दायित्व	दायित्व
dayitvon	दायित्वों	दायित्वों
dayityon	दायित्यों	दायित्वों
darul	दररुल	दारूल
daav	दाव	दाव
daaw	दाव	दाव
dav	दाव	दाव
daw	दाव	दाव
daah	दाह	दाह
dah	दहह	दाह
dikhla	दिखला	दिखला
dikhlaa	दिखला	दिखला
dikhaaiye	दिखाइए	दिखाइये
dikhaiye	दिखाइए	दिखाइये
dikhaai	दिखाई	दिखाई
dikhai	दिखाई	दिखाई
dikhayi	दिखाई	दिखाई
dikhaaee	दिखाई	दिखाईं
dikhaai	दिखाई	दिखाईं
dikhaain	दिखाइें	दिखाईं
dikhaee	दिखाई	दिखाईं
dikhai	दिखाई	दिखाईं
dikhayin	दिखाययंं	दिखाईं
dikhai	दिखाई	दिखायी
dikhayi	दिखाई	दिखायी
dikhaai	दिखाई	दिखार्इ
dikhae	दिखाए	दिखार्इ
dikhai	दिखाई	दिखार्इ
dikhayi	दिखाई	दिखार्इ
dita	दीता	दिता
ditaa	दीता	दिता
dinaank	दिनांक	दिनांक
dinank	दीनांक	दिनांक
dirham	दिरहहम	दिरहम
dilaaye	दिलाए	दिलाये
dilaye	दिलाए	दिलाये
deewani	दीवानी	दिवानी
diwani	दीवानी	दिवानी
divy	दिवीय	दिव्य
divya	दिव्य	दिव्य
divyata	दिव्यता	दिव्यता
divya	दिव्य	दिव्या
deepan	दीपान	दीपन
deepn	दीपन	दीपन
dipan	दीपान	दीपन
deepsingh	डीपिसंं	दीपसिंह
dipsingh	डिप्सिंं	दीपसिंह
deepika	दीपीका	दीपिका
dipika	दीपिकक	दीपिका
deeya	दीया	दीया
diya	दिया	दीया
dukaanon	दुकानों	दुकानों
dukanon	दुकानों	दुकानों
dukke	दुक्के	दुक्के
dukhan	दुखनन	दुखन
dukhit	दुखित	दुखित
dukhiyon	दुखियों	दुखियों
dukhon	दुखों	दुखों
dubhashiyon	दुभाषियों	दुभाषियों
durgun	दुर्गुन	दुर्गुण
durghatna	दूर्घतनन	दुर्घटना
durghtna	दूर्घतान	दुर्घटना
duneerti	दुनरीती	दुर्नीति
durniti	दूर्णिति	दुर्नीति
durbhiksh	दुर्भिक्ष	दुर्भिक्ष
duvidhaaen	दुविधाएं	दुविधाएं
duvidhaayein	दुविधाएं	दुविधाएं
duvidhaen	दुविधाएं	दुविधाएं
duwaidhaayein	दुवाधाएं	दुविधाएं
dune	दूने	दूने
doordarshan	दूरदर्शन	दूरदर्शन
durdarshan	दुरदर्शन	दूरदर्शन
dradh	द्राध	दृढ़
dridh	द्रिध	दृढ़
dekhoge	देखेगो	देखोगे
denevaali	देनेवाली	देनेवाली
denevali	देनेवाली	देनेवाली
denewaali	देनेवाली	देनेवाली
denewali	देनेवाली	देनेवाली
deonar	डियोनर	देवनार
devnaar	देवनारर	देवनार
devnar	देवनार	देवनार
devaapur	देवापुर	देवापुर
devapur	देवापुर	देवापुर
devi	देवी	देवी
devisingh	डिविसंंल	देवीसिंह
devisinh	डिविसांज	देवीसिंह
deshkaal	देशकाल	देशकाल
deshkal	देशकाल	देशकाल
deshke	देशके	देशके
desai	डेसाई	देसाई
doge	डोगे	दोगे
dvadash	द्वादश	द्वादश
dwaadas	द्वादास	द्वादश
dvivedi	द्वीवेदी	द्विवेदी
dwivedi	द्वीवेदी	द्विवेदी
dhande	धंडेे	धंधे
dhandhe	धांढे	धंधे
dhndhe	ढंंढे	धंधे
dhandhon	धांधों	धंधों
dhandon	धंडोंं	धंधों
dhakelte	धकेलेत	धकेलते
dhkelate	धेकेेते	धकेलते
dhatana	धातना	धटना
dhatna	धातना	धटना
dhankuber	धनकुुबेर	धनकुबेर
dhanadhany	धनाधन्न	धनधान्य
dhandhaanya	धंधान्य	धनधान्य
dhandhany	धंधधनय	धनधान्य
dhandhanya	धंधन्य	धनधान्य
dhamkaataa	धमकता	धमकाता
dhamkata	धमकता	धमकाता
dhamm	धम्म	धम्म
dhamma	धम्म	धम्मा
dhammaa	धम्मा	धम्मा
dharmnath	धर्मनाथ	धर्मनाथ
dharmraj	धर्मराज	धर्मराज
dharmesh	धर्मेशश	धर्मेश
dhasmaanaa	धस्माना	धस्माना
dhasmana	धम्ममान	धस्माना
dhaak	धाक	धाक
dhak	ढकक	धाक
dhaaga	धागा	धागा
dhaagaa	धागा	धागा
dhaga	धागा	धागा
dhaatuein	धातुएं	धातुएं
dhaatuyein	धातुयंं	धातुएं
dhtuen	धत्ुुं	धातुएं
dhaarak	धारकक	धारक
dharak	धारक	धारक
dhaari	धारी	धारी
dhari	धारी	धारी
dhuan	धुआं	धुआं
dhunaai	धुणाई	धुनाई
dhunai	धुणाई	धुनाई
dhuriya	धूरिया	धुरिया
dhuriyaa	धूरिया	धुरिया
dhuni	धुंी	धूनी
dhairyavaan	धार्यवानान	धैर्यवान
dhairyawan	धार्यवावनन	धैर्यवान
dhiryavan	धृर्यववन	धैर्यवान
dhiryawaan	धृर्यवानान	धैर्यवान
dhokebaaj	धोकेबाज	धोखेबाज
dhokebaaz	धोखेबाज	धोखेबाज
dhokebaj	धोकेबाज	धोखेबाज
dhokebaz	धोखेबाज	धोखेबाज
dhokhebaaj	धोखेबाज	धोखेबाज
dhokhebaj	धोखेबाज	धोखेबाज
dhona	धोना	धोना
dhonaa	धोना	धोना
dhoraaji	धोराजी	धोराजी
dhoraji	धोराजी	धोराजी
dhoron	धोरों	धोरों
dhyeyavaadi	ध्ययववादी	ध्येयवादी
dhyeywadi	ध्यववादी	ध्येयवादी
dyeyvadi	दीयववादी	ध्येयवादी
dhrupad	धृरपपद	ध्रुपद
drupad	द्रुपद	ध्रुपद
nandanvan	नंदवावनन	नंदनवन
nadsa	नादसा	नक्सल
naksal	नकसलल	नक्सल
naxal	नकलल	नक्सल
naksalavaad	नक्ललवाद	नक्सलवाद
naksalwaad	नक्लवावाद	नक्सलवाद
naksalwad	नक्ललवाद	नक्सलवाद
naxalvaaad	नकललवाद	नक्सलवाद
naxalwaad	नकललवाद	नक्सलवाद
naksaliyon	नकसललियों	नक्सलियों
naxaliyon	नकललयों	नक्सलियों
naksali	नकसलली	नक्सली
naxali	नकली	नक्सली
nagaada	नगदाा	नगाड़ा
nagaadaa	नगदाा	नगाड़ा
nagaaraa	नगगरा	नगाड़ा
nageene	नगीनन	नगीने
nagine	नागीन	नगीने
najarandaaj	नजरअंदाज	नजरंदाज
najarandaaz	नजरअंदाज	नजरंदाज
nazarandaaj	नज़रंदाज	नजरंदाज
nazarandaaz	नजरअंदाज	नजरंदाज
nazarandaz	नजरअंदाज	नजरंदाज
najraane	नजराान	नजराने
nazraane	नज़राने	नजराने
najariyon	नजररययों	नजरियों
najriyon	नजरियों	नजरियों
najron	नजररों	नजरों
najeeb	नजीीब	नजीब
najib	नाजिब	नजीब
najibabaad	नाजीबाबाद	नजीबाबाद
najibabad	नाजिबाबाद	नजीबाबाद
najeem	नजजीम	नजीम
najim	नाजिम	नजीम
nazeem	नजजीम	नजीम
nana	नान	नना
nanaa	ननना	नना
nna	ननन	नना
nanhe	नन्हे	नन्हें
nanhein	ना्हें	नन्हें
nabj	नब्ज	नब्ज़
nabja	नब्ज	नब्ज़
nabz	नब्ज	नब्ज़
namkeen	नमकीन	नमकीन
namkin	नामकीन	नमकीन
narnaari	नरणारी	नरनारी
narnari	नरणारी	नरनारी
narbhakshi	नरभभषषी	नरभक्षी
naram	नररम	नरम
narm	नर्म	नरम
narmi	नर्मी	नरमी
narsanhar	नरसंहहर	नरसंहार
narsanharon	नरसंजारों	नरसंहारों
november	नूवबंर	नवंबर
navketan	नवेक्तन	नवकेतन
navjaagaran	नवाजगरण	नवजागरण
navjagran	नवाजग्रण	नवजागरण
navdha	नवधा	नवधा
navvadhoo	नववाधु	नववधू
navvadhu	नववाधु	नववधू
nava	नवा	नवा
navaa	नवा	नवा
navate	नवाते	नवाते
navanagar	नववगगर	नवानगर
nawanagar	नववगगर	नवानगर
navya	नव्य	नव्या
naseem	नसीम	नसीम
nasim	नसीम	नसीम
nights	नाइट्स	नाइट्रस
nitrous	नाइट्रोजस	नाइट्रस
nineteez	निनीटीज	नाइनटीज
nineties	निनिटेस	नाइनटीज
ninties	नांटीज	नाइनटीज
nau	नौऊ	नाऊ
nauu	नौऊ	नाऊ
naakaam	नाकाम	नाकाम
nakam	नकमम	नाकाम
naagrik	नागरिक	नागारिक
nagarik	नागरिक	नागारिक
nagrik	नागरिक	नागारिक
nagin	नगीनन	नागिन
nadep	नडदेप	नाडेप
nanak	ननकक	नानक
nanavati	नानवती	नानावती
napane	नापने	नापने
napne	नापने	नापने
napa	नापा	नापा
naam	नाम	नाम
naamdhari	नामधारी	नामधारी
namdhari	नामधारी	नामधारी
namankano	नममानकों	नामांकनों
namankanon	नममकननोंं	नामांकनों
namavaliyon	नमावलियों	नामावलियों
naamo	नामों	नामो
namo	नामो	नामो
nayak	नायक	नायक
naraji	नरराजी	नाराजी
naraingarh	नारेंगढ़	नारायणगढ़
narayangadh	नार्यंगढ़	नारायणगढ़
narayangarh	नार्यंगढ़	नारायणगढ़
naasar	नासरर	नासर
nahargadh	नहररगढ़	नाहरगढ
nahargarh	नहररगग़	नाहरगढ
nikalegi	निकालेगी	निकलेगी
nikalogi	निकालोगी	निकलेगी
nikaalani	निकालनी	निकालनी
nikaalni	निकालनी	निकालनी
nikalani	निकलनी	निकालनी
nikalni	निकलनी	निकालनी
nicki	निकीक	निकी
nicky	निककी	निकी
niki	निकी	निकी
niketan	निकेटन	निकेतन
nikhar	निखार	निखर
nikhari	निखारी	निखरी
nigar	निगरर	निगर
nigger	निगगेर	निगर
nichala	निचला	निचला
nichalaa	निचला	निचला
nichla	निचला	निचला
nitiyon	नित्यियों	नितियों
nitya	नित्य	नित्या
nityaa	नित्या	नित्या
nidhaan	निधान	निधान
nidhan	निधान	निधान
nipatara	निपटरा	निपटारा
niptaara	निपटारा	निपटारा
niptaaraa	निपतारा	निपटारा
niptara	निपटारा	निपटारा
niyanta	नियंता	नियंता
niyantaa	नियंता	नियंता
niya	नीय	निया
niyaa	निया	निया
nirdeshika	निर्देशिकक	निर्देशिका
nirdeshikaa	निर्देशिका	निर्देशिका
nirdhaarit	निर्धारित	निर्धारित
nirdharit	निर्धारित	निर्धारित
nirbaadh	निर्बद	निर्बाध
nirbadh	निर्बद	निर्बाध
niveshakartaa	निवेशक्रता	निवेशकर्ता
niveshkarta	निवेषक्रता	निवेशकर्ता
niveshkartaa	निवेषक्रता	निवेशकर्ता
nischal	निश्चा	निश्चल
nishchal	निश्चा	निश्चल
nishnaat	निश्नता	निष्णात
nishpaap	निष्पाप	निष्पाप
nihalaani	निहालनी	निहलानी
nihlaani	निहाानी	निहलानी
nihlani	निहानी	निहलानी
nihaalchand	निहालंंद	निहालचंद
nihalchand	निहालचंद	निहालचंद
neechaaee	नीचाई	नीचाई
nichaai	निचाई	नीचाई
neat	नीट	नीट
neet	नीत	नीट
neetiyon	नीतीयों	नीतियों
nitiyon	नित्यियों	नीतियों
neelagaay	नीलाग़	नीलगाय
nilgai	निलगाई	नीलगाय
neelaabh	नीलाभ	नीलाभ
nilaabh	निलाभ	नीलाभ
nilabh	निलाभ	नीलाभ
nuskhe	नुस्खे	नुस्खे
noon	नून	नून
nun	नून	नून
noobiyaa	नूबिया	नूबिया
nubiya	नुबिया	नूबिया
nrityashaili	नृत्याशाली	नृत्यशैली
nrutyashaili	नृत्याशाली	नृत्यशैली
nrityon	नृत्यों	नृत्यों
nrutyon	नृत्यययों	नृत्यों
neco	नेक्को	नेको
neko	नेकों	नेको
nectar	नेक्टर	नेक्टर
neg	नेग	नेग
nega	नेगा	नेग
networking	नेटवर्किंग	नेटवर्किग
neto	नेटो	नेटो
neta	नेता	नेता
nemo	नेमो	नेमो
nelsan	नेल्सन	नेल्सन
nelson	नेल्सन	नेल्सन
nations	नैशिसंस	नेशंस
nehara	नेहरा	नेहरा
nehra	नेहरा	नेहरा
naino	नैयों	नैनो
nano	न्नों	नैनो
naivedh	नैवेद	नैवेद्य
naivegh	नैवेघ	नैवेद्य
nevedya	नेवेद्य	नैवेद्य
nominate	नॉमिनेट	नॉमिनेट
naukari	नौकरी	नोकरी
naukri	नौकरी	नोकरी
nokari	नोकरी	नोकरी
nokri	नोकरी	नोकरी
notes	नोटेस	नोट्स
nora	नोरा	नोरा
nori	नोरी	नोरी
nauner	नौनेर	नौनेर
nauvahan	नौवाहन	नौवहन
naushad	नौषदद	नौशाद
panchaang	पंचांग	पंचांग
panchang	पांचंं	पंचांग
punchang	पंचंग	पंचांग
punjab	पुंजब	पंजाब
punjabiyon	पंजािियों	पंजाबियों
pantar	पंतरर	पंटर
panter	पैंटर	पंटर
punter	पंटर	पंटर
pakaayein	पकाएं	पकाएं
pakaayen	पकाएं	पकाएं
pakaen	पकाएं	पकाएं
pakayen	पकाएे	पकाएं
pakaude	पकडड़े	पकौड़े
pakshapat	पक्षाप्प	पक्षपात
pakshpaat	पक्षापत	पक्षपात
pakshpat	पक्षापत	पक्षपात
pagabadha	पगगदाध	पगबाधा
pagbadha	पगबदाध	पगबाधा
pagalaa	पगला	पगला
pagla	पगला	पगला
pachaataa	पचाता	पचाता
pachata	पचाता	पचाता
patakkar	पटकककर	पटककर
patkathaayein	पत्काएाएं	पटकथाएं
patkathaein	पटककाएं	पटकथाएं
patkathayen	पत्काथाएं	पटकथाएं
patki	पटकी	पटकी
pataraani	पतारणी	पटरानी
patrani	पत्रणी	पटरानी
patavaari	पतवारी	पटवारी
patwari	पतवारी	पटवारी
pataakshep	पताक्षेप	पटाक्षेप
patachep	पत्चेप	पटाक्षेप
patakshep	पत्क्षेप	पटाक्षेप
patiya	पटिया	पटिया
patiyaa	पटिया	पटिया
padaraunaa	पददरुण	पडरौना
padrauna	पददरुण	पडरौना
padega	पडेगा	पड़ेगा
padegaa	पडेगा	पड़ेगा
padha	पढ़ा	पढ़ा
padhaa	पढ़ा	पढ़ा
padhaataa	पढ़ता	पढ़ाता
padhata	पढ़ता	पढ़ाता
patili	पटिली	पतीली
padamawati	पदामावती	पदमावती
padmavati	पद्मावती	पदमावती
padmawati	पद्मावती	पदमावती
padadhikari	पदाधिकारी	पदाधिकारी
panapnaa	पनन्ना	पनपना
panpana	पापनान	पनपना
panaamaa	पनमा	पनामा
panama	पनमा	पनामा
paneer	पनीरर	पनीर
pammi	पामम	पम्मी
pammu	पामम	पम्मी
pummi	पुम्मी	पम्मी
pummy	प्मी	पम्मी
pardesiyon	परददससियों	परदेसियों
pardesi	पर्देसी	परदेसी
parva	पर्वा	परवा
parvaa	पर्वा	परवा
parwa	पर्वा	परवा
parwaa	परवा	परवा
paraadheen	पराधीन	पराधीन
paraadhin	पराधीन	पराधीन
paradheen	पराधीन	पराधीन
paradhin	पराधीन	पराधीन
parikalpit	परिकल्पित	परिकल्पित
parimal	परिमाल	परिमल
parishad	परिशाद	परिषद
parishadiy	परिशादी	परिषदीय
parishadiya	परिशादीय	परिषदीय
parishadon	परिशादों	परिषदों
parikhaen	परिकाएं	परीक्षाएं
parikshaayein	परिक्षाएं	परीक्षाएं
parikshaen	परिक्षाएं	परीक्षाएं
parosane	परोसने	परोसने
parosne	परोसनें	परोसने
parda	परदा	पर्दा
pardaa	परदा	पर्दा
purple	पुरप्ले	पर्पल
palatne	पलटटने	पलटने
paltane	पल्टने	पलटने
palaari	पलारी	पलारी
palari	पलारी	पलारी
pale	पाले	पले
palmonari	पा्मोनोरी	पल्मोनरी
pulmonary	पुलेनोयर	पल्मोनरी
plus	प्लॉस	पल्स
pulse	पुल्स	पल्स
pashtun	पशष्टुं	पश्तून
pashtuun	पाष्टुओं	पश्तून
pahan	पहनन	पहन
pehan	पहनन	पहन
pahantaa	पहनता	पहनता
pahnata	पहन्ता	पहनता
pehnate	पहनाते	पहनता
pahanate	पहनाते	पहनते
pahante	पहनतते	पहनते
pehnate	पहनाते	पहनते
pahnaakar	पहनाकर	पहनाकर
pahnakar	पहनाकर	पहनाकर
pehnakar	पहनाकर	पहनाकर
pahnaati	पहनाती	पहनाती
pahnati	पहनती	पहनाती
pehnati	पहनती	पहनाती
pahani	पहनीी	पहनी
pahni	पहनी	पहनी
pehni	पहनी	पहनी
pahno	पहनों	पहनो
pehno	पहनों	पहनो
pahla	पहला	पहला
pahlaa	पहला	पहला
pehla	पहहा	पहला
paheliyaan	पहेलियां	पहेलियां
paheliyan	पहेलियां	पहेलियां
paheliyon	पहेलियों	पहेलियों
pide	पीड़े	पाइड
pied	पीयड	पाइड
pythagoras	पितागागोर	पाइथागोरस
pythogaras	पिथोगगरास	पाइथागोरस
paakhandi	पाखंडी	पाखंडी
pakhandi	पखंडडी	पाखंडी
paathshaalaayein	पाठशालाएं	पाठशालाएं
pathshalayein	पठ्शालाएं	पाठशालाएं
pathshalayen	पठ्शालाएं	पाठशालाएं
paathyakram	पाठ्यकर्म	पाठ्यक्रम
pathyakram	पाठ्यकर्म	पाठ्यक्रम
pathykram	पाठिक्रम	पाठ्यक्रम
paathyakramon	पाठ्क्रकमों	पाठ्यक्रमों
pathyakramon	पाठ्क्रममों	पाठ्यक्रमों
pathykramon	पाठ्क्रममों	पाठ्यक्रमों
population	पॉपुललशनन	पापुलेशन
pailot	पैलोोो	पायलट
pilot	पिलोो	पायलट
pailoton	पेलोटों	पायलटों
piloton	पिलोटों	पायलटों
paarampariktaa	पारपपररितता	पारंपरिकता
paramparikata	परंपर्िकता	पारंपरिकता
paramparikta	परंपर्किता	पारंपरिकता
parnel	परनेल	पार्नेल
parnell	पर्नेल	पार्नेल
parleron	पार्ररों	पार्लरों
parloron	परर्रोो	पार्लरों
parlouron	परर्ररों	पार्लरों
paarshad	पारशद	पार्षद
parshad	परशशद	पार्षद
paarshadon	पारशदों	पार्षदों
parshadon	परशशदों	पार्षदों
parshdon	पर्शदों	पार्षदों
policy	पॉलिसि	पालिसी
pinta	पिंटा	पिंटा
pintaa	पिंता	पिंटा
piega	पीएगा	पिएगा
piyegaa	पियेगा	पिएगा
pic	पिक	पिक
pick	पिक	पिक
pik	पीक	पिक
piki	पिकी	पिकी
piky	पिक्यी	पिकी
picture	पिक्चर	पिक्चर
pigmentation	सिजमेंेेशन	पिगमेंटेशन
pigs	पिग्स	पिग्स
pichde	पिछडे	पिछड़े
pichhade	पिछड़े	पिछड़े
pijja	पिजजा	पिज्जा
pizza	पिजजाज	पिज्जा
pitaamaha	पितामाहा	पितामह
pitamah	पितामा	पितामह
pipra	पिपरर	पिपरा
pipraa	पिपरा	पिपरा
pipli	पिपलली	पिपली
pearson	पिर्सन	पियरसन
pierson	पियर्न	पियरसन
peary	पिरर	पियरी
piyari	पियारी	पियरी
pisaai	पिसाई	पिसाई
pisai	पिसाई	पिसाई
pihaani	पिहानी	पिहानी
pihani	पिहानी	पिहानी
pib	पीब	पीआईबी
pr	प्री	पीआर
pml	प्मल	पीएमएल
pmo	प्मो	पीएमओ
pmch	पंच	पीएमसीएच
psv	प्वव	पीएसवी
peaking	पीकिंग	पीकिंग
picking	पिककंंग	पीकिंग
peetne	पीतनन	पीटने
pitne	पितनन	पीटने
pedia	पेडिया	पीडिया
pidiya	पीड़िया	पीडिया
pidiyaa	पीड़िया	पीडिया
peelepan	पीलेपन	पीलेपन
pilepan	पिलेपन	पीलेपन
pv	प्वी	पीवी
pisa	पीसा	पीसा
putla	पुतला	पुतला
putlaa	पुतला	पुतला
putaliyaan	पुटलियां	पुतलियां
putliyan	पुटलियां	पुतलियां
putaliyon	पुतललयों	पुतलियों
putliyon	पुतलियों	पुतलियों
putali	पुतली	पुतली
putli	पुतली	पुतली
putale	पुतले	पुतले
putle	पूटले	पुतले
putin	पुटिन	पुतिन
putul	पुतुल	पुतुल
punargathan	पुनर्गतान	पुनर्गठन
puna	पुणा	पुना
puraane	पुराने	पुराने
purane	पुराने	पुराने
puru	पुरु	पुरू
purjon	पुर्जों	पुर्जों
purzon	पुर्जों	पुर्जों
pulam	पुलाम	पुलम
pushkin	पुश्कीं	पुश्किन
pushkarana	पुष्करण	पुष्करणा
pushkarna	पुष्करण	पुष्करणा
pushkarnaa	पुष्करण	पुष्करणा
pushp	पुष्प	पुष्प
pushpa	पुष्प	पुष्प
pushpa	पुष्प	पुष्पा
pushpaa	पुष्ा	पुष्पा
pushpit	पुष्पित	पुष्पित
pushpon	पुष्पों	पुष्पों
poonjikaran	पुंजीकरण	पूंजीकरण
punjikaran	पुंजीकरण	पूंजीकरण
poojaapaath	पूजापठठ	पूजापाठ
poojapath	पूजपाठ	पूजापाठ
pujapath	पूजापठ	पूजापाठ
pooranpur	पुराणपुर	पूरनपुर
puranpur	पुराणपुर	पूरनपुर
purvaabhaas	पूर्वाभाष	पूर्वाभास
purvaabhas	पूर्वाभास	पूर्वाभास
purvabhaas	पूर्वाभास	पूर्वाभास
purvabhas	पूर्वाभास	पूर्वाभास
pendulam	पेंदुल्म	पेंडुलम
pendulum	पेंडुलुल	पेंडुलम
peg	पेग	पेग
pages	पेग्स	पेजेज
pajej	पजेजे	पेजेज
pace	पेस	पेस
pes	पेस	पेस
pastry	पास्त्री	पेस्ट्री
pangolin	पंगोलिनी	पैंगोलिन
pengolin	पेंगोलिनी	पैंगोलिन
packard	पैकरर्ड	पैकर्ड
package	पैकेज	पैकेज
packageon	पैकाजियों	पैकेजों
packagon	पककगोंं	पैकेजों
packajon	पककजों	पैकेजों
paim	पैमम	पैम
pam	पाम	पैम
paratrooper	पररतरूपूर	पैराट्रूपर
peratrupers	पैर्टरपूर्स	पैराट्रूपर
paranormal	परोनरोमल	पैरानॉर्मल
peranormal	पररोनोमॉल	पैरानॉर्मल
paraffin	परफफिन	पैराफिन
parafin	पराफिन	पैराफिन
perafin	पररफिइन	पैराफिन
parabola	परबोलल	पैराबोला
perabola	पररबोलल	पैराबोला
polimer	पॉलीमम	पॉलिमर
polymer	पॉलीमर	पॉलिमर
polishing	पोलीशिंग	पॉलिशिंग
pokar	पोकर	पोकर
poker	पोकर	पोकर
polish	पोलिश	पोलिश
poshit	पोशित	पोषित
posta	पोस्त	पोस्ता
pau	पौऊ	पौ
pyade	प्याद	प्यादे
prakriya	प्रकृरिय	प्रक्रिया
prakshepak	प्रक्षेपक	प्रक्षेपक
pratigya	प्रतिज्ञ	प्रतिज्ञा
prtigyaa	प्रतिग्ञा	प्रतिज्ञा
pratibhutiyan	प्रतिभूतियां	प्रतिभूतियां
pratiyon	प्रतियों	प्रतियों
prativaad	प्रतिवाद	प्रतिवाद
prativad	प्रतिवाद	प्रतिवाद
prativadi	प्रतिवादी	प्रतिवादी
pratishat	प्रतिष्ट	प्रतिशत
praneet	प्रणीत	प्रनीत
pranit	प्रणित	प्रनीत
prapaat	प्रपात	प्रपात
prapat	प्रपात	प्रपात
prapaaton	प्रपातों	प्रपातों
prapaton	प्रपत्तों	प्रपातों
prabodhini	प्रबोधिनी	प्रबोधिनी
prayaasrat	प्रयास्रत	प्रयासरत
prayasarat	प्रयसस्रत	प्रयासरत
pradarshan	प्रदर्शन	प्रर्दशन
prardashan	प्रद््ाशन	प्रर्दशन
pravati	प्रवतत	प्रवत्ति
pravatti	प्रवत्ति	प्रवत्ति
prashaasanik	प्रशासनिि	प्रशासनिक
prashasanik	प्रश्सानिक	प्रशासनिक
prashasnik	प्रश्सनिि	प्रशासनिक
prashaasanon	प्रशासनों	प्रशासनों
prashansanon	प्रशंसनों	प्रशासनों
prashasanon	प्रशासनों	प्रशासनों
prashikshu	प्रशिक्षु	प्रशिक्षु
prastaavon	प्रस्तावों	प्रस्तावों
prastavon	प्रस्त्वों	प्रस्तावों
prahlaad	प्रहादा	प्रहलाद
prahlad	प्रहाल	प्रहलाद
prahasan	प्रहासन	प्रहसन
prahsan	प्रहससन	प्रहसन
prahaarak	प्रहारक	प्रहारक
praharak	प्रहारक	प्रहारक
prahad	प्रहाद	प्रह्लाद
prahlad	प्रहाल	प्रह्लाद
privacy	प्रिवास	प्राइवेसी
praakkathan	प्रकक्ठान	प्राक्कथन
prakkathan	प्रकक्ठान	प्राक्कथन
praan	प्रान	प्राण
pran	प्रणण	प्राण
pranon	प्रणों	प्राणों
prathamik	प्राथमििक	प्राथमिक
prathmik	प्राथमििक	प्राथमिक
praathmikata	प्राम्मिकता	प्राथमिकता
prathmikta	प्राथममिकता	प्राथमिकता
prathmiki	प्रम्मििक	प्राथमिकी
pradhyapakon	प्रध्ययपकों	प्राध्यापकों
prapt	प्रप््त	प्राप्त
prapta	प्रपत्त	प्राप्त
prapti	प्राप्ति	प्राप्ती
praroop	प्रदूप	प्रारूप
prarup	प्रदूप	प्रारूप
priyamani	प्रियमानी	प्रियामणि
proof	प्रूफ	प्रूफ
pruf	प्रफ	प्रूफ
prekshakon	प्रेक्षकों	प्रेक्षकों
prem	प्रीम	प्रेम
premlata	प्रेमलाता	प्रेमलता
prema	प्रेमा	प्रेमा
premi	प्रेमी	प्रेमी
profit	प्रोफििट	प्रॉफिट
processing	प्रोसेसिंग	प्रॉसेसिंग
programers	प्रोग्राम्स	प्रोग्रामर्स
programmers	प्रोग्राम्स	प्रोग्रामर्स
programs	प्रोग्रा््	प्रोग्रामर्स
proto	प्रोतों	प्रोटो
propellant	प्रेपेलेंट	प्रोपेलेंट
propellent	प्रेपेलेंट	प्रोपेलेंट
praudh	प्रदु़	प्रौढ
proud	प्रुु	प्रौढ
plan	प्लान	प्लेन
plane	प्लाने	प्लेन
fund	फंंड	फंड
funda	फुंडा	फंडा
funding	फंंडिंग	फंडिंग
fandon	फंंडों	फंदों
fagua	फागुआ	फगुआ
fatane	फटनने	फटने
phatane	फटनेे	फटने
phatne	फटनेे	फटने
fadfadata	फड़दाडता	फड़फड़ाता
phadphadata	फड़दा़ता	फड़फड़ाता
fatehgadh	फटेबाढ़	फतेहगढ़
fatehgarh	फटेबाढ़	फतेहगढ़
fabti	फाबती	फब्ती
phabti	फबबीी	फब्ती
farse	फार्स	फरसे
pharase	फररेस	फरसे
pharse	फार्स	फरसे
farheen	फरहीन	फरहीन
farhin	फरहीन	फरहीन
farth	फर्थ	फर्थ
ferth	फेर्थ	फर्थ
pharth	फर्थ	फर्थ
farmion	फार्मियों	फर्मिऑन
fermion	फर्मियन	फर्मिऑन
firmian	फिर्मियन	फर्मिऑन
farookhabad	फरुखाबाब	फर्रुखाबाद
farrukhabad	फरीखाबाब	फर्रुखाबाद
farukhabad	फरुखाबाब	फर्रुखाबाद
farookhnagar	फरुखनंगर	फर्रूखनगर
farrukhnagar	फर्खोंगार	फर्रूखनगर
farukhnagar	फरुखनंगर	फर्रूखनगर
falata	फललता	फलता
falta	फललता	फलता
phalata	फलता	फलता
falne	फालने	फलने
phalne	फलने	फलने
falitarth	फलीतार्थ	फलितार्थ
phalitartha	फलितर्थथ	फलितार्थ
falibhoot	फलीभूत	फलीभूत
falibhut	फलीभूत	फलीभूत
phalibhoot	फलीभूत	फलीभूत
favvara	फववारा	फव्वारा
fawaara	फवारा	फव्वारा
favvare	फववारर	फव्वारे
fawaare	फवारर	फव्वारे
favvaron	फववारों	फव्वारों
fawaaron	फवारों	फव्वारों
faisala	फैैसला	फ़ैसला
faisla	फैैसला	फ़ैसला
follow	फोलों	फ़ॉलो
faansi	फांसी	फांसी
fansi	फैंसी	फांसी
fatama	फटमम	फातमा
fatma	फट्मम	फातमा
faaf	फाफ	फाफ
phaaph	फाफ	फाफ
farsi	फार्सी	फारसी
forcee	फॉर्स	फारसी
farm	फर्म	फार्म
form	फॉर्म	फार्म
farmic	फार्मिक	फार्मिक
formic	फॉर्मिक	फार्मिक
formulae	फोर्मुलय	फार्मूले
formule	फॉर्मूलू	फार्मूले
formuley	फॉर्मूलू	फार्मूले
pharmacy	फर्मयसी	फार्मेसी
pharma	फरमा	फार्मों
pharmon	फर्मों	फार्मों
farms	फर्ममस	फार्म्स
finger	फिंगर	फिंगर
fikra	फिककर	फिक्र
physician	फिजिसियन	फिजिशियन
firti	फिर्टी	फिरती
fisla	फिस्ला	फिसला
fislaa	फिसला	फिसला
feeder	फीडर	फीडर
fulaaye	फुलाए	फुलाए
fulae	फुलाए	फुलाए
fulay	फुला	फुलाए
furti	फुर्ती	फूर्ति
phurti	फूर्ती	फूर्ति
fus	फुस	फूस
phoos	फूस	फूस
phus	फूस	फूस
feka	फेका	फेका
fefada	फेफड़ा	फेफड़ा
fefda	फेफडा	फेफड़ा
facial	फेशियल	फेशियल
fact	फैक्ट	फैक्ट
federal	फेडरल	फैडरल
failkar	फैलकर	फैलकर
failaaiye	फैलाया	फैलाइए
failaea	फैलाया	फैलाइए
failaiya	फैलाया	फैलाइए
failaiye	फैलाये	फैलाइए
failegi	फैलेगी	फैलेगी
font	फॉंट	फॉन्ट
fogat	फोगत	फोगाट
phogat	फोगत	फोगाट
fod	फोड	फोड़
phod	फोड़	फोड़
foda	फोड़	फोड़ा
fodaa	फोड़ा	फोड़ा
phoda	फोड़	फोड़ा
fode	फोड़	फोड़े
phode	फोड़	फोड़े
fodo	फ़डोो	फोड़ों
fodon	फ़ड़ों	फोड़ों
phodo	फोडोो	फोड़ों
fortis	फॉर्टिस	फोर्टिस
fusion	फुज़ों	फ्यूजन
fuji	फुजी	फ्यूजी
fyuji	फ्यीजी	फ्यूजी
francisca	फ्रांसिसिक	फ्रांसिस्का
franciska	फ्रांसिक्का	फ्रांसिस्का
fransiska	फ्रांसिसका	फ्रांसिस्का
francisco	फ्रैंसिक्को	फ्रांसिस्को
francisko	फ्रैंसिक्सों	फ्रांसिस्को
fransisko	फ्रांसिक्सो	फ्रांसिस्को
fringe	फ्रांग	फ्रिंज
friendship	फ्रेंदशशपप	फ्रेंडशिप
frost	फ्रोस्ट	फ्रॉस्ट
flin	फ्लायन	फ्लिन
flynn	फ्लायन	फ्लिन
flesh	फ्लेश	फ्लेश
bang	बंगा	बंग
bung	बंंग	बंग
bangbandhu	बागंबदुध	बंगबंधु
bangbhang	बंगभांग	बंगभंग
bangash	बंगाश	बंगश
bangsh	बंंगशश	बंगश
bantane	बंटटने	बंटने
bantne	बंटटने	बंटने
bandhati	बंधधती	बंधती
bandhti	बांधती	बंधती
bandhan	बंधन	बंधान
bandhuon	बंधुओं	बंधुओं
bamba	बाबबा	बंबा
mumba	मुंबा	बंबा
bakaayon	बकाययों	बकायों
bakayon	बकाययों	बकायों
bakaul	बकौलल	बकौल
bakoul	बैकूल	बकौल
baksa	बक्स	बक्सा
baksi	बकसी	बक्सी
bakse	बकसे	बक्से
bakhshane	बख़शनन	बख्शने
bakhshne	बख़षने	बख्शने
bagad	बगगा	बगड़
bagd	बगद्	बगड़
bageechi	बगीीी	बगीची
bagichi	बगीीी	बगीची
bachat	बचात	बचत
bachati	बचाती	बचती
bachti	बचतीी	बचती
bajana	बजनान	बजना
bajrangi	बजरंंगग	बजरंगी
bajaj	बजजजज	बजाज
batalvi	बतलावी	बटालवी
badhachadhakar	बढ्चाधकर	बढ़ाचढ़ाकर
badata	बड़ता	बढ़ाता
badhaataa	बढ़ाता	बढ़ाता
badhata	बढ़ता	बढ़ाता
badhaati	बढ़ाती	बढ़ाती
badhati	बढ़ती	बढ़ाती
badhayi	बढ़ायी	बढ़ायी
badhav	बढ़व	बढ़ाव
badhotari	बधोतरारी	बढ़ोतरी
badhotri	बधधोत्री	बढ़ोतरी
batlaae	बतलाएा	बतलाए
batlaaye	बतलाए	बतलाए
batlae	बतलाए	बतलाए
batlaye	बतलाए	बतलाए
batlaakar	बतलाकर	बतलाकर
batlakar	बतलाकर	बतलाकर
badlapur	बदलाापुर	बदलापुर
badali	बदली	बदली
badli	बदली	बदली
badam	बददाम	बदाम
banva	बनवा	बनवा
banvaa	बनवा	बनवा
banaam	बनाम	बनाम
banam	बनाम	बनाम
bnaam	बनाम	बनाम
baniya	बानिया	बनिया
banu	बनुू	बनू
barpaayaa	बरपायया	बरपाया
barpaya	बर्पाया	बरपाया
barsa	बरसस	बरसा
barsaata	बरसाता	बरसाता
barsaataa	बरसाता	बरसाता
barsata	बरससता	बरसाता
barhad	बरहहा	बरहद
baraat	बरातत	बरात
barat	बररत	बरात
braat	ब्रात	बरात
baraamad	बरामदा	बरामद
baramad	बरामद	बरामद
bramad	ब्रमदड	बरामद
baramade	बरममदे	बरामदे
baramde	बरममदे	बरामदे
bare	बारर	बरे
birth	बिर्थ	बर्थ
baljeet	बल्ीीत	बलजीत
baljit	बल्ीित	बलजीत
ballabh	बल्लाभ	बल्लभ
balla	बल्ला	बल्ला
balli	बल्ली	बल्ली
basava	बसवव	बसावा
bastiyon	बस्तियों	बस्तियों
bahroopiya	बहररपपयय	बहरूपिया
bahrupiya	बहरुपीय	बहरूपिया
bahamaas	बहममसस	बहामास
bahamas	बहममस	बहामास
bahaav	बहहव	बहाव
bahav	बहवव	बहाव
bhav	भाव	बहाव
bahavalpur	बाहाललपुर	बहावलपुर
bahawalpur	बहालालपरर	बहावलपुर
bahuchara	बहुचारा	बहुचरा
banthia	बंथिया	बांठिया
banthiya	बंथिया	बांठिया
bandhate	बंधधते	बांधते
bandhte	बंधठते	बांधते
banbi	बांबी	बांबी
bombi	बॉंबबी	बांबी
bounceron	बाउंसेरों	बाउंसरों
bowling	बोलिंगिं	बाउलिंग
baku	बककू	बाकू
bakuu	बककू	बाकू
baag	बाग	बाग
bag	बगग	बाग
bagh	बाघ	बाग
bagabani	बगबानी	बागबानी
bagbani	बगबानी	बागबानी
bagali	बगली	बागली
bagli	बगली	बागली
baagiyon	बागियों	बागियों
bagiyon	बागियों	बागियों
baago	बागों	बागो
bago	बागो	बागो
baji	बाजी	बाज़ी
bazi	बाजी	बाज़ी
bajaru	बाजारु	बाजारू
bazaru	बजजररु	बाजारू
bajuon	बाजूओं	बाजुओं
badh	बड़	बाध
badha	बढ़	बाधा
baadhaaon	बाधाओं	बाधाओं
baadhaon	बाधाओं	बाधाओं
badhaaon	बढधाओं	बाधाओं
badhaon	बढधाओं	बाधाओं
baadhit	बाधित	बाधित
badhit	बढ़ित	बाधित
baani	बानी	बानी
bani	बानी	बानी
baapa	बापपा	बापा
baapaa	बापा	बापा
bapa	बापा	बापा
bapaa	बापा	बापा
baabat	बाबतत	बाबत
babat	बबबत	बाबत
babt	बबत्	बाबत
bayern	बायर्न	बायर्न
byrun	ब्ररून	बायर्न
barah	बारह	बारह
baarahamaasee	बारमहासी	बारहमासी
barahamasi	बर्हममसी	बारहमासी
barahmasi	बर्हमससी	बारहमासी
barahsinga	बहरसिसंग	बारहसिंगा
barasingha	बररसिंघह	बारहसिंगा
bala	बाला	बाला
baalti	बालती	बाल्टी
balti	बल्ती	बाल्टी
balty	बाल्टी	बाल्टी
baldvin	बललव्वीन	बाल्डविन
baldwin	बालव्वीन	बाल्डविन
bavaji	बवाजी	बावजी
bavji	बावजी	बावजी
baawaraa	बावरा़ा	बावरा
bavra	बववरा	बावरा
bawara	बववरा	बावरा
baahulya	बहुु्लय	बाहुल्य
bahuly	बहुल्ली	बाहुल्य
bahulya	बहुल्य	बाहुल्य
box	बॉक्क	बाॅक्स
bikherati	बिखेरती	बिखेरती
bikherti	बिखरर्ती	बिखेरती
biggest	बाजगेस्ट	बिगेस्ट
bichhua	बिच्आु	बिछुआ
bichhuaa	बिचुआ	बिछुआ
biji	बीजीज	बिजी
busy	बुसी	बिजी
buzy	बुजी	बिजी
bipin	बिपिनिन	बिपिन
bilae	बिलाए	बिलाई
bilai	बिलाई	बिलाई
billa	बिल्ला	बिल्ला
billaa	बिल्ला	बिल्ला
bilhaur	बिलाहौर	बिल्हौर
bisva	बिस्वा	बिस्वा
biswa	बिस्वा	बिस्वा
bag	बगग	बीएजी
bikaner	बिककेनर	बीकानेर
bikaneri	बिकनेरी	बीकानेरी
bk	बकक	बीके
beejak	बीजक	बीजक
bijak	बिजकक	बीजक
beef	बीफ	बीफ
beem	बीम	बीम
bim	बीम	बीम
beemon	बीमों	बीमों
bimon	बामों	बीमों
beerganj	बीरगंंज	बीरगंज
birganj	बिरगगंज	बीरगंज
beesavaan	बीसवान	बीसवां
bisavan	बिसवान	बीसवां
bisawan	बिसवान	बीसवां
beast	बेस्ट	बीस्ट
budvig	बुड़विग	बुडविग
budwig	बुड़विग	बुडविग
bull	बुल्ल	बुल
bulaao	बुलाओं	बुलाओ
bulao	बुलाओ	बुलाओ
bule	बुले	बुले
bulletin	बुलेटिनन	बुलेटिन
brijesh	ब्रेजेश	बृजेश
benvar	बेनवार	बेंवर
benwar	बेनवार	बेंवर
beaulad	बीलुल	बेऔलाद
bekaaboo	बेकबूू	बेकाबू
bekabu	बेकबूब	बेकाबू
bechakar	बेचाकर	बेचकर
bechkar	बेचकर	बेचकर
bechate	बेचते	बेचते
bechte	बेचते	बेचते
bediyan	बेडियां	बेड़ियां
bethanal	बेथनालन	बेथनल
bethnal	बेथनाल	बेथनल
benis	बेनिस	बेनिस
belacha	बेलच्छा	बेलचा
belcha	बेलचा	बेलचा
belinda	बेलींडा	बेलिंडा
bevkufana	बेवकुखना	बेवकूफाना
bewakoofaanaa	बेवकूखना	बेवकूफाना
bewkufana	बेककुखनन	बेवकूफाना
besahaaraa	बेशहारा	बेसहारा
besahara	बेशहारा	बेसहारा
basin	बसीनन	बेसिन
besin	बेसिनन	बेसिन
basil	बासिल	बेसिल
besil	बेसिलल	बेसिल
bandage	बंदगे	बैंडेज
bandej	बंददेज	बैंडेज
baithantey	बैठंतते	बैठते
baithate	बैठाते	बैठते
baitool	बैटूल	बैतूल
baitul	बैतुल	बैतूल
betul	बेटुल	बैतूल
baini	बैनी	बैनी
beni	बेनी	बैनी
bairakpur	बैरकापुर	बैरकपुर
barrackpore	बररककपपरर	बैरकपुर
baila	बैला	बैला
bella	बेल्ला	बैला
ballistic	बाल्लिस्टिक	बैलिस्टिक
bells	बेल्स	बैल्स
bostan	बोस्टनन	बॉस्टन
bosten	बोस्टेन	बॉस्टन
boston	बोस्टों	बॉस्टन
bokaro	बोकरोर	बोकारो
bodara	बोडारा	बोदरा
bodra	बोड़र	बोदरा
bodraa	बोद़ा	बोदरा
bona	बोना	बोना
borkar	बॉरककर	बोरकर
borivali	बोरिवाली	बोरीवली
boriwali	बोरिवाली	बोरीवली
born	बॉर्न	बोर्न
bolane	बोलने	बोलने
boliae	बोलिया	बोलिए
boliy	बोलिय	बोलिए
boliye	बोलिया	बोलिए
bosaan	बोसानं	बोसान
bosan	बोससन	बोसान
bauni	बौनी	बौनी
bouni	बौनीनी	बौनी
byaawa	ब्ाावा	ब्यावर
byavar	ब्यववर	ब्यावर
brajesh	ब्राजेश	ब्रजेश
brijesh	ब्रेजेश	ब्रजेश
brahmalin	ब्रा्ममालीन	ब्रह्मलीन
brahmleen	ब्रा््ममीी	ब्रह्मलीन
brahmlin	ब्रा््ममीी	ब्रह्मलीन
bravo	ब्रववो	ब्रावो
brigatn	ब्रिगटनन	ब्रिगटन
brighton	ब्राइटों	ब्रिगटन
brigton	ब्रिगटनन	ब्रिगटन
brigadier	ब्रागडीीर	ब्रिगेडियर
britain	ब्रिटेनन	ब्रिटेन
breed	ब्रीड	ब्रीद
brock	ब्रॉकक	ब्रोक
brok	ब्रोक	ब्रोक
broke	ब्रॉक	ब्रोक
brocken	ब्रॉककेन	ब्रोकन
broken	ब्रोक्न	ब्रोकन
blosam	ब्लोससम	ब्लॉसम
blossom	ब्लोसॉस	ब्लॉसम
bhagaane	भगगने	भगाने
bhagane	भगगने	भगाने
bhadakaaya	भड़काया	भड़काया
bhadakaya	भड़कका	भड़काया
bhadkaayaa	भड़काया	भड़काया
bhadkaya	भड़कका	भड़काया
bharakaaya	भऱकका	भड़काया
bharakaya	भऱकका	भड़काया
bhabhoot	भभूूत	भभूत
bhabhut	भभभूत	भभूत
bhay	भाय	भय
bhaya	भाया	भय
bhayo	भायों	भयो
bharatanatyam	भारतनात्मय	भरतनाट्यम्
bharatnatyam	भारतनात्मम	भरतनाट्यम्
bhartnatyam	भर्तननत्यम	भरतनाट्यम्
bharate	भऱते	भरते
bharte	भररते	भरते
bharani	भरणीी	भरनी
bharni	भरणी	भरनी
bharane	भऱने	भरने
bharne	भरनने	भरने
bhara	भररा	भरा
bhavishya	भविष्ष	भविष्य
bhaate	भाते	भाते
bhate	भाते	भाते
bhanu	भानु	भानू
bhabar	भाबर	भाबर
bhareeye	भारीय	भारीय
bhariy	भारीय	भारीय
bhavanaon	भववनाओं	भावनाओं
bhavnaon	भावनाओं	भावनाओं
bhaskar	भासककर	भास्कर
bheed	भीड़	भीड़
bheera	भीरा	भीरा
bhira	भिरा	भीरा
bheesham	भीषम	भीष्म
bhisham	भिश्म	भीष्म
bhishm	भिश्षम	भीष्म
bhugat	भुगतत	भुगत
bhugata	भुगता	भुगता
bhugta	भुगता	भुगता
bhutto	भूट्टट	भुट्टो
bhumi	भूमि	भुमि
bhurbhura	भूरभुरा	भुरभुरा
bhookh	भूखख	भूख
bhukh	भुखा	भूख
bhookhi	भूखी	भूखी
bhukhi	भुखी	भूखी
bhoogol	भूगोलो	भूगोल
bhugol	भूगोलो	भूगोल
bhootal	भूताल	भूतल
bhutal	भूताल	भूतल
bhoopsingh	भूपसिंं	भूपसिंह
bhupsingh	भूपसिंह	भूपसिंह
bhumi	भूमि	भूमी
bhumika	भूमिका	भूमी
bhulata	भुलाता	भूलता
bhulataa	भुलाता	भूलता
bhulta	भुलता	भूलता
bhula	भुला	भूला
bhulaa	भुला	भूला
bhooli	भूलि	भूली
bhuli	भूली	भूली
bhulo	भूलो	भूलो
bhulon	भूलों	भूलों
bhusi	भूसी	भूसी
bhooswaami	भूस्वामी	भूस्वामी
bhusvami	भूस्वामी	भूस्वामी
bhuswami	भूस्वामी	भूस्वामी
bhengapan	भेंगापनन	भेंगापन
bhairavnath	भैरतननाथ	भैरवनाथ
bhairo	भैरोो	भैरो
bhogatey	भोगते	भोगते
bhogte	भोगते	भोगते
bhola	भोला	भोला
bholi	भोली	भोली
bholu	भोलूल	भोलू
bhaunho	भौनोहों	भौंहों
bhaunhon	भौनोहों	भौंहों
bhoonhon	भूनहों	भौंहों
bhraant	भ्रांत	भ्रांत
bhrant	भ्रंत	भ्रांत
brant	ब्रंट	भ्रांत
bhraanti	भ्रंती	भ्रांति
bhranti	भ्रंती	भ्रांति
branti	ब्रंती	भ्रांति
bhraantiyan	भ्रंतियां	भ्रांतियां
bhrantiyan	भ्रंतियां	भ्रांतियां
bhraantiyon	भ्रातियों	भ्रांतियों
bhrantiyon	भ्रंतियों	भ्रांतियों
mangesh	मंगेशश	मंगेश
manch	मांच	मंच
manchit	माचचित	मंचित
mancheeye	मंचीय	मंचीय
manchiy	मांचीय	मंचीय
manchiya	मंचिया	मंचीय
manchon	मैंचों	मंचों
manjil	माजजिल	मंजिल
manzil	माजजिल	मंजिल
manjila	मंजीला	मंजिला
manzila	मंजीला	मंजिला
manjilein	मांजेलें	मंजिलें
manjilen	मानजेलें	मंजिलें
manzilein	मांजिलें	मंजिलें
manto	मैटटो	मंटो
mantriyon	मंत्रियों	मंत्रियों
makrani	मकराणी	मकरानी
maksad	मकसाद	मक्सद
makhdumpur	मख़दपुुर	मखदुमपुर
machaaye	मचाए	मचाए
machae	मचाए	मचाए
machaye	मचाए	मचाए
machaanon	मचानों	मचानों
machanno	मच्नोंं	मचानों
machano	मच्नों	मचानों
machanon	मचननों	मचानों
madaura	मददरा	मढ़ौरा
madhuara	मधुरर	मढ़ौरा
madhura	मधुरा	मढ़ौरा
manipal	मनिपााल	मणिपाल
matpatron	मत्त्त्रों	मतपत्रों
matthe	मट्ठे	मत्थे
matsyavatar	मात्यययवातर	मत्स्यावतार
matsyavtar	मात्यययवातर	मत्स्यावतार
masyendranath	मासीयंद्रनाथ	मत्स्येंद्रनाथ
matsyendranath	मतत्सिंर्दनाथ	मत्स्येंद्रनाथ
madhupur	मधुपुर	मधुपुर
manmarji	मंमर्जी	मनमर्जी
manae	मााय	मनाए
manaye	मनाये	मनाए
mnaey	मनाए	मनाए
mam	माम	मम
mum	मूम	मम
maryokar	मार्योकर	मयोर्का
mayorka	मैय्रका	मयोर्का
mayorkaa	मैय्रका	मयोर्का
mardaani	मरददानी	मरदानी
mardani	मरददानी	मरदानी
marmar	मरममर	मरमर
murmur	मुरमूर	मरमर
maratha	मररथा	मराठा
marathi	मररथी	मराठी
marji	मर्जी	मर्जी
mardanagi	मर्ददंगी	मर्दानगी
mardangi	मर्दंंगी	मर्दानगी
mardo	मार्डों	मर्दों
mardon	मरद्ोों	मर्दों
maryaadaa	मर्यदा	मर्यादा
maryada	मारयदा	मर्यादा
maryaadaaon	मर्यदाओं	मर्यादाओं
maryadaon	मर्यदाओं	मर्यादाओं
malaga	मलला	मलागा
malaar	मलाार	मलार
malar	मललर	मलार
mashrak	माश्रक	मशरक
masaaledaar	मसालेदार	मसालेदार
masaledaar	मसललेदार	मसालेदार
masaledar	मासलेेडर	मसालेदार
masoor	मसूरर	मसूर
masur	मसूरर	मसूर
masse	मसससे	मस्से
mahakane	महाकाने	महकने
mahakne	महाकने	महकने
mahkane	महककाने	महकने
mehkane	मेहकनन	महकने
mahalon	महालों	महलों
mahlon	महलों	महलों
mahagranth	महाग्रंत	महाग्रंथ
mhagranth	महागररंथ	महाग्रंथ
mahajan	महाजन	महाजन
mhajan	महाजन	महाजन
mahathir	महातीर	महाथिर
mhathir	महातीर	महाथिर
mahanatam	महानत्म	महानतम
mahantam	महानतमम	महानतम
mhantam	महानतम	महानतम
mahanideshak	महानेदेशक	महानिदेशक
mahanirdeshak	महोनिद्वेशक	महानिदेशक
mhanideshak	महानेदेशक	महानिदेशक
mahapauron	महापरों	महापौरों
mhapauron	महापारों	महापौरों
mahapran	महाप्रण	महाप्राण
mhapran	महाप्रण	महाप्राण
mahamantr	महामंत्र	महामंत्र
mahamantra	महामंत्र	महामंत्र
mhamantra	महामंत्र	महामंत्र
maharaja	महारजजा	महाराजा
mahavigyan	महाविज्ञान	महाविज्ञान
mhavidyan	महाविद्ञान	महाविज्ञान
mahavidya	महाविद्य	महाविद्या
mhavidya	महाविद्य	महाविद्या
mahavishnu	महाविशानु	महाविष्णु
mahasingh	महासिंघ	महासिंह
mahasinh	महासिंह	महासिंह
mahipal	महीपाल	महिपाल
mahin	महिं	महीन
mahinon	महिनों	महीनों
maang	मांग	मांग
mang	मांग	मांग
mangani	मंगानी	मांगनी
mangni	मांगनी	मांगनी
maanga	मांगा	मांगा
manga	मंगा	मांगा
maangi	मांगी	मांगी
mangi	मंगी	मांगी
maange	मांगे	मांगे
mange	मांगे	मांगे
mango	मांगों	मांगो
maori	मौरी	माओरी
maajin	माजीन	माजिन
majin	मजीन	माजिन
mathe	माठ	माथे
mathey	माथी	माथे
maap	मापप	माप
map	मापप	माप
mop	मोप	माप
mamooli	ममूूली	मामूली
mamuli	मामूली	मामूली
mame	मैम	मामे
maarvaad	मारववाद	मारवाड़
marvad	मार्वाद	मारवाड़
marwar	मारवार	मारवाड़
maariya	मारिया	मारिया
mariya	मरियय	मारिया
maariyo	मारियों	मारियो
mario	मैरियो	मारियो
mariyo	मरिियों	मारियो
martha	मार्थ	मार्था
maalish	मालिश	मालिश
malish	मालिश	मालिश
mave	मावे	मावे
mavey	मावे	मावे
maas	मास	मास
mas	मास	मास
mass	मास	मास
maason	मासों	मासों
mason	मासों	मासों
mitaao	मिताओं	मिटाओ
mitao	मिताओं	मिटाओ
mithaai	मिठाई	मिठाई
mithai	मिठाई	मिठाई
media	मेडिया	मिडिया
mithila	मिथिला	मिथिला
mithilanchal	मिथिचांचल	मिथिलांचल
mithya	मिथ्य	मिथ्या
mimicry	मिमिक्कर	मिमिक्री
milkiyat	मिलकियता	मिल्कियत
misha	मिशा	मिशा
mungeri	मंंगेरी	मुंगेरी
mundva	मुंडवा	मुंडवा
mundwa	मुंडवा	मुंडवा
munshiganj	मुशिंजंज	मुंशीगंज
mukarte	मुकर्ते	मुकरते
mukartey	मुकर्ते	मुकरते
mukhopadhyaya	मुखोतायाययय	मुखोपाध्याय
mukhyopadhyaay	मुख्याोय्ययय	मुखोपाध्याय
mukhyamantri	मुख्यमंत्री	मुख्यमंत्री
munaf	मुनाफ	मुनाफ
munafa	मुनाफा	मुनाफा
munnu	मुन्नो	मुन्नू
mufalisi	मुफालिसी	मुफलिसी
muflisi	मुफलिसससी	मुफलिसी
mubarakpur	मूब्रापुर्	मुबारकपुर
mubarkpur	मूब्रकपुर	मुबारकपुर
murjha	मुर्झा	मुर्झा
multae	मुलतताा	मुल्ताई
multai	मुल्तता	मुल्ताई
mushahid	मुशिहि	मुशाहिद
muhavare	मुहावार	मुहावरे
muhavre	मुहावरे	मुहावरे
mooth	मूठ	मूठ
muth	मूठ	मूठ
mood	मूद	मूड
mud	मुद	मूड
moodi	मूदी	मूडी
moody	मूद्य	मूडी
mool	मूल	मूल
mul	मूल	मूल
moolchand	मूलछंद	मूलचंद
mulchand	मूलचंं	मूलचंद
moolar	मूलर	मूलर
mular	मुलरर	मूलर
muller	म्लूलर	मूलर
moolon	मूलों	मूलों
mulon	मूलों	मूलों
maxico	मैक्सिकोक	मेक्सिको
mexico	मैक्किकोक	मेक्सिको
mega	मेगा	मेगा
megapixal	मेग्ािशिकक	मेगापिक्सल
megapixel	मैग्यिस्ेेस	मेगापिक्सल
mejbaan	मेजबान	मेजबान
mejban	मेजबान	मेजबान
mezbaan	मेजबान	मेजबान
mejabani	मेजबानी	मेजबानी
mejbaani	मेबबानी	मेजबानी
mejbani	मेबबानी	मेजबानी
mezabani	मेजबानी	मेजबानी
mejbaan	मेजबान	मेज़बान
mejban	मेजबान	मेज़बान
mezbaan	मेजबान	मेज़बान
mejbaani	मेबबानी	मेज़बानी
mejbani	मेबबानी	मेज़बानी
mezbaani	मेबबानी	मेज़बानी
mate	माते	मेट
met	मेट	मेट
mates	मैटेस	मेट्स
medical	मेडिकल	मेडीकल
methanol	मेथननलल	मेथेनॉल
menu	मेनु	मेनू
mem	मेम	मेम
melaghaat	मेलाघाट	मेलघाट
melghat	मेलघाट	मेलघाट
melaanin	मेलानिन	मेलानिन
melanin	मेलानिन	मेलानिन
melaani	मेलानी	मेलानी
melani	मेलानी	मेलानी
maheman	महेमान	मेहमान
mehamaan	मेहमान	मेहमान
mehaman	मेहमान	मेहमान
mehmaan	मेहमान	मेहमान
mehman	मेहमान	मेहमान
meharaam	मेहराम	मेहराम
mehram	मेहराम	मेहराम
macbook	मककूक	मैकबुक
matix	मैट्किक	मैट्रिक्स
matrix	मैट्रिक्क	मैट्रिक्स
mad	मदद	मैड
made	मेड	मैड
maid	मैद	मैड
maddy	मदद्ी	मैडी
maidi	मैदी	मैडी
main	मैन	मैन
man	मान	मैन
men	मेन	मैन
mainan	मैइनन	मैनन
menon	मेनों	मैनन
manner	मनननर	मैनर
maina	मैइना	मैना
maine	मैइने	मैने
marrej	मररेज	मैरेज
marriage	मैरिजजज	मैरेज
merraige	मैरेजज	मैरेज
maisachusets	मैसाचुस्ट	मैसाचुसेट्स
massachusetts	मैसेचेस्ट्स	मैसाचुसेट्स
maisor	मैसोर	मैसोर
maisore	मैसूरो	मैसोर
mysore	मैसूर	मैसोर
mod	मोड	मॉड
mode	मोड़	मॉड
modern	मॉडर्न	मॉडर्न
module	मॉडुल	मॉड्यूल
modules	मॉडल्ल	मॉड्यूल्स
modyuls	मॉड्यल््	मॉड्यूल्स
mauritious	मॉरिशशश	मॉरिशस
mauritius	मॉरिशिस	मॉरिशस
mogali	मोगली	मोगली
mowgli	मोगगली	मोगली
motive	मोटिटव	मोटिव
mol	मॉल	मोल
mold	मोल््	मोल्ड
moshe	मोशे	मोशे
mosad	मोसाद	मोसाद
mohana	मोहना	मोहाना
mohani	मोहनी	मोहानी
mohini	मोहिनी	मोहिनी
mohim	मोहिम	मोहिम
maukon	मौकों	मौकों
mauma	मौमा	मौमा
maurya	मौर्य	मौर्या
morya	मोर्य	मौर्या
maurya	मौर्य	मौर्यों
mauryon	मौर्यों	मौर्यों
moryon	मोर्यों	मौर्यों
maulaviyon	मौलावियों	मौलवियों
maulvidon	मौलविदों	मौलवियों
maulviyon	मौलवियों	मौलवियों
maule	मॉले	मौले
mauley	मॉले	मौले
mausa	मौसा	मौसा
yatn	यत्न	यत्न
yatna	यतनन	यत्न
yada	यादा	यदा
yda	यदद	यदा
yaduvansh	यगुवंंश	यदुवंश
yaduwansh	यगुवंंश	यदुवंश
jerusalem	जेरेस्लम	यरूशलेम
yarooshaleim	यरूशेली	यरूशलेम
yarushalem	यररशशेल	यरूशलेम
yashpaal	यपप्लल	यशपाल
yashpal	यपप्लल	यशपाल
yaatna	यातना	यातना
yatna	यतनन	यातना
yaatanaon	यातनाओं	यातनाओं
yatnaon	यातनाां	यातनाओं
yarayan	यारययन	यात्राएं
yatraein	यात्राएं	यात्राएं
yatraen	यात्राएं	यात्राएं
yaariyan	यारियां	यारियां
yariyan	यरियां	यारियां
yaari	यारी	यारी
yari	यारी	यारी
yugam	युगाम	युग्म
yugm	युग्म	युग्म
yuddhrat	युद्धृत	युद्धरत
yudhrat	युद्धता	युद्धरत
ukrainian	युक्रिनियन	यूक्रेनियन
ukranian	युक्रिनियन	यूक्रेनियन
jerusalem	जेरेस्लम	येरुशलम
yorker	यॉर्कर	यॉर्कर
yojanaein	योजनाएंं	योजनाएं
yojanaen	योजनाएां	योजनाएं
yojanaye	योजनाए	योजनाएं
rangate	रंगतते	रंगते
rangte	रंगटे	रंगते
rangkata	रंगकका	रंजकता
ranjkatha	रंजकता	रंजकता
ranjkta	रणजक्ता	रंजकता
raees	रीस	रईस
rais	रैस	रईस
raktaabh	रक्तभू	रक्ताभ
raktabh	रक्तभू	रक्ताभ
rakhna	रखना	रखना
raghupati	रघुपत्ति	रघुपति
raghuram	रघुररमम	रघुराम
registerd	रजजस्टर्ड	रजिस्टर्ड
registered	रेजस्टरेड	रजिस्टर्ड
ratanpur	रतननपुर	रतनपुर
runners	रन्नर्	रनर्स
rayan	रायन	रयान
ryan	र्यान	रयान
ralhan	रल्हन	रल्हन
ravish	रविष	रविश
ravael	रवाले	रवैल
ravel	रवेल	रवैल
rawail	रावलल	रवैल
rasad	रसदद	रसद
rasaayanik	रसायननिक	रसायनिक
rasaayanika	राायननिक	रसायनिक
rasayanika	राााननिक	रसायनिक
rasyanik	रा््यनिक	रसायनिक
rasaayanon	रसायनों	रसायनों
rasayanon	रसायनों	रसायनों
rahamat	रहमतत	रहमत
rahmat	रहमत	रहमत
rhamat	रहमत	रहमत
rahenge	रहेंगे	रहेंगे
rahegi	रहेगी	रहेगी
rounder	राउंडर	राउंडर
raak	राक	राक
rak	रकक	राक
raakhe	राखे	राखे
rakhe	रखे	राखे
raagon	रागों	रागों
ragon	रगगों	रागों
raghavan	रागवान	राघवन
raaj	राज़	राज
raj	राज	राज
rajkot	राजकोत	राजकोट
rajtantra	राजतंं्र	राजतंत्र
raajneetikaran	राजनीतीकरण	राजनीतीकरण
rajneetikaran	राजनीतीकरण	राजनीतीकरण
rajnitikaran	राजनीतीकरण	राजनीतीकरण
rajma	राजमा	राजमां
rajman	राजमान	राजमां
raajasva	राजस्व	राजस्व
rajasva	राजस्व	राजस्व
raaji	राजी	राजी
raji	राजी	राजी
rajinaama	राजीनमा	राजीनामा
rajinama	राजीनमा	राजीनामा
raajon	राजों	राजों
rajon	राजों	राजों
rana	रान	राणा
raatrichar	रात्तिचार	रात्रिचर
ratrichar	रत्तिचार	रात्रिचर
raadhe	राढ़	राधे
radhe	राढ़	राधे
ranapur	रणनपुर	रानापुर
rabin	रबीनी	राबिन
robin	रोबिनी	राबिन
rabha	रभभ	राभा
ramkot	रामकोट	रामकोट
ramkote	रामकोटे	रामकोट
ramtek	रामेेक	रामटेक
rampur	रामपुर	रामपुर
rambharose	रंमभरोस	रामभरोसे
rambharosey	रामभर्स	रामभरोसे
ramraj	रामराज	रामराज
raalod	रालोड	रालोद
ralaud	राौौद	रालोद
ralod	रालोड	रालोद
ravaley	रवाले	रावले
ravle	रावले	रावले
rasayanik	राायनििक	रासायनिक
racreation	रेक्रियोशन	रिक्रिएशन
recreation	रिक्रिरेशन	रिक्रिएशन
rig	रिग	रिग
riggs	रिगग्स	रिग्स
rigs	रिग्स	रिग्स
richual	रिचुल	रिचुअल
ritual	रितुकल	रिचुअल
reduction	रेडिक्शन	रिडक्शन
ripan	रिपान	रिपन
ripon	रिपों	रिपन
ria	रिया	रिया
riya	रिया	रिया
rishte	रिश्टे	रिश्ते
rishtey	रिश्टे	रिश्ते
risane	रिसने	रिसने
risaney	रिसने	रिसने
risne	रिसने	रिसने
rihana	रिहान	रिहाना
rihanna	रहहनना	रिहाना
regal	रेगल	रीगल
rigal	रिगल	रीगल
reasonal	रेसानोल	रीजनल
regional	रेलियनइं	रीजनल
retreate	रिट्रीटट	रीट्वीट
retweet	रेट्वीट	रीट्वीट
reeta	रीता	रीता
rita	रीता	रीता
rukate	रुकते	रुकते
rukte	रुकते	रुकते
ruktey	रुकते	रुकते
rugan	रूग्ण	रुग्ण
rugna	रूग्ण	रुग्ण
ruganta	रुगानता	रुग्णता
rugnata	रूगनाता	रुग्णता
rojvelt	रोजवेल्ट	रुजवेल्ट
roojwelt	रूजवेल्ट	रुजवेल्ट
roosevelt	रूशवेल्ट	रुजवेल्ट
rodolph	रोडोलोफ	रुडोल्फ
rudolf	रूडोल्फ	रुडोल्फ
rudolph	रूडोल्फेफ	रुडोल्फ
roopesh	रूपेष	रुपेश
rupesh	रूपेश	रुपेश
ruby	रूबी	रुबी
roomani	रूमानी	रुमानी
rumani	रुमानी	रुमानी
rukavaton	रुकावतों	रूकावटों
root	रूत	रूट
route	रूटत	रूट
rooting	रुटिंगं	रूटिंग
routine	रोटियनन	रूटिंग
routing	रुयटिंग	रूटिंग
roots	रुट्स	रूट्स
routes	रुउट्स	रूट्स
roopak	रुपकक	रूपक
rupak	रुपक	रूपक
roopi	रुपी	रूपी
rupi	रुपी	रूपी
rantle	रंटटे	रेंटल
rental	रेंटल	रेंटल
registan	रेजस्टान	रेगिस्तान
registani	रिजस्तानी	रेगिस्तानी
reja	रेजा	रेजा
reza	रेजा	रेजा
rate	राते	रेट
rate	राते	रेत
ret	रेट	रेत
refaeli	रेफालल	रेफेली
refeli	रेफेली	रेफेली
reshe	रेशे	रेशे
reshey	रेशे	रेशे
race	रेस	रेस
rese	रेसी	रेस
racer	रेसर	रेसर
recer	रिसरर	रेसर
racing	रेसिंग	रेसिंग
reson	रेसों	रेसों
rehaana	रहहाना	रेहाना
rehana	रहहाना	रेहाना
racketeer	रेकेटीर	रैकेटियर
racketier	रेकेटियर	रैकेटियर
rectare	रेक्टरेरर	रैकेटियर
radical	रेडिकल	रैडिकल
raidical	रेडिकिल	रैडिकल
raith	रैठ	रैथ
rapping	रैपिंगग	रैपिंग
wrapping	व्पपिंगं	रैपिंग
robertsan	रोबर्््सन	रॉबर्टसन
robertson	रॉबर्सनस	रॉबर्टसन
robinson	रोबियनसस	रॉबिंसन
royals	रॉयॉल्स	रॉयल्स
rojlin	रोजलिन	रोजलिन
rozlyn	रोजलिन	रोजलिन
rotation	रोटेशेन	रोटेशन
rodrigo	रोडरिगोग	रोड्रिगो
ronaldo	रोनाल्ोो	रोनाल्डो
ronit	रोनिट	रोनित
roni	रोनी	रोनी
ropane	रोपने	रोपने
ropaney	रोपने	रोपने
ropne	रोपनें	रोपने
robin	रोबिनी	रोबिन
roya	रोया	रोया
rollers	रॉलर्स	रोलर्स
rovan	रोवान	रोवन
rowan	रोवान	रोवन
rosario	रोसरियो	रोसारियो
rosariyo	रोसरियों	रोसारियो
raubadaar	राबददार	रौबदार
raubadar	राबददार	रौबदार
raubdar	राबदार	रौबदार
landara	लंददा	लंगड़ा
langada	लंगगडा	लंगड़ा
langda	लंंगडा	लंगड़ा
langar	लंगार	लंगर
langaron	लंगारों	लंगरों
langron	लंंगरों	लंगरों
lambi	लाबबी	लंबी
lakeer	लकीीर	लकीर
lakir	लकककर	लकीर
lakiron	लककरोंों	लकीरों
lakme	लक्े	लक्मे
lakshmidhar	लक्ष्मीधार	लक्ष्मीधर
lakshmighar	लक्ष्मीचार	लक्ष्मीधर
lakshy	लक्ष्य	लक्ष्य
lakshya	लक्ष्य	लक्ष्य
lakshyon	लक्ष्यों	लक्ष्यों
lux	लुक्क	लक्स
laksar	लाकसर	लक्सर
luxor	ल्कूकर	लक्सर
lakhkhi	लख्खी	लख्खी
lagna	लगनन	लगना
laganewale	लगानेवाले	लगनेवाले
lagnevaaley	लगगनेवाले	लगनेवाले
lagnewale	लागनेवाले	लगनेवाले
lagega	लगेगग	लगेगा
lajjalu	लज़जलल	लज्जालु
latkate	लटककेे	लटकाते
ladki	लड़कक	लड़की
ladate	लाड़ते	लड़ते
ladte	लाड़ते	लड़ते
ladaai	लड़ाई	लड़ाई
ladai	लड़ाई	लड़ाई
ladaaiyon	लड़ाययों	लड़ाईयों
ladaeyon	लड़ाययों	लड़ाईयों
ladaiyon	लड़ाययों	लड़ाईयों
lapetane	लपपटटने	लपेटने
lapetne	लपपटटेन	लपेटने
labada	लाबाा	लबादा
lbada	लदाडा	लबादा
labdh	लाब्	लब्ध
lbdh	लल्ड	लब्ध
lalak	लालकक	ललक
lalkarata	लालकर्ता	ललकारता
lalkarta	लालकर्ता	ललकारता
lalla	लल्ला	लल्ला
lavasa	लावासा	लवासा
lovasa	लोवासा	लवासा
lassi	लासी	लस्सी
lahanaa	लहना	लहना
lahna	लानना	लहना
lehna	लेहना	लहना
lahraee	लहरायी	लहराई
lahrai	लहरावी	लहराई
lehrayi	लहरायी	लहराई
lahalhati	लहहहाती	लहलहाती
lahlahaati	लहहहाती	लहलहाती
lahlahati	लहहहाती	लहलहाती
lahsun	लाससून	लहसुन
lasoon	लासून	लहसुन
lanchar	लांचर	लांचर
launcher	लॉउचचर	लांचर
lycopene	लिकोपपपनन	लाइकोपिन
lime	लामम	लाइम
lives	लिवेस	लाइव्स
live	लिवव	लाईव
laegi	लागी	लाएगी
lagataar	लगातार	लागातार
lagatar	लगातार	लागातार
laata	लाता	लाता
lata	लटता	लाता
laati	लाती	लाती
lati	लाटी	लाती
layega	लायगा	लायेगा
lalpur	लालपुर	लालपुर
las	लास	लास्ट
last	ला््ट	लास्ट
lindbhed	लिंदभेद	लिंगभेद
lingbhed	लिंघभेद	लिंगभेद
lindan	लिंडन	लिंडन
lindn	लिंडन	लिंडन
lindon	लिंडों	लिंडन
likhakar	लिखाकर	लिखकर
likhkar	लिखकर	लिखकर
ligar	लिगरर	लिगर
liger	लाइगर	लिगर
liberation	लाइब्रेशन	लिबरेशन
libration	लाइब्रेशन	लिबरेशन
liberation	लाइब्रेशन	लिब्रेशन
libration	लाइब्रेशन	लिब्रेशन
leaderon	लीडरों	लीडरों
leedaron	लीदारों	लीडरों
lidaron	लिदारों	लीडरों
liidaron	लिद़रों	लीडरों
louis	लुजस	लुईस
luis	लुइस	लुईस
ludhakate	लुढ़कते	लुढ़कते
ludhkate	लुढ़कतत	लुढ़कते
lurhakate	लुढ़ककत	लुढ़कते
lutf	लटफ	लुत्फ
lumding	लुडडिंग	लुमडिंग
lootmaar	लूटमामर	लूटमार
lootmar	लूटममर	लूटमार
landal	लंंलल	लेंडल
lendal	लेंडल	लेंडल
lega	लेगा	लेगा
legaa	लेगा	लेगा
letakar	लेटाकर	लेटकर
letkar	लेटकर	लेटकर
lenevali	लेनेवाली	लेनेवाली
lenewali	लेनेवाली	लेनेवाली
label	लेबेल	लेबल
labeling	लेबेलिंग	लेबलिंग
labelling	लेबेलिंग	लेबलिंग
labelo	लेबेलो	लेबलों
labelon	लेबेलों	लेबलों
lebalon	लेबालों	लेबलों
lemon	लेमों	लेमन
laingadan	लैंगाान	लैंगडन
langdon	लंंगडों	लैंगडन
lengdan	लेंग्ान	लैंगडन
laigikata	लैगीकता	लैंगिकता
laingikta	लैंगिकता	लैंगिकता
lanset	लैंसेट	लैंसेट
lenset	लेंसेट	लैंसेट
lairi	लैरी	लैरी
lairy	लैरर	लैरी
larry	लैर्	लैरी
lace	लेस	लैस
less	लेस	लैस
locket	लॉकेेट	लॉकेट
laundry	लैंंड्री	लॉन्ड्री
longewal	लोंगेवाल	लोंगोवाल
longewala	लोंगेवाला	लोंगोवाल
longoval	लोंगोवाल	लोंगोवाल
log	लॉग	लोग
loge	लोगे	लोगे
lochdar	लोचदार	लोचदार
lodi	लोडी	लोदी
laurence	लॉरेंस	लौरेंस
laurens	लॉरेंस	लौरेंस
laurense	लॉरेंस	लौरेंस
wonder	वेंडर	वंडर
vansh	वंष	वंश
vanshdhar	वंशधार	वंशधर
vanshavad	वंशवावद	वंशवाद
vanshvaad	वंशववाद	वंशवाद
vanshvad	वंशववद	वंशवाद
wanshwad	वंशववद	वंशवाद
vajood	वजूद	वजूद
vajud	वाजुद	वजूद
wajood	वजूद	वजूद
vadali	वादली	वडाली
vadli	वादली	वडाली
wadali	वादली	वडाली
vanita	वाणित	वनिता
vareinye	वैरेन	वरेण्य
varenya	वेरेन्य	वरेण्य
varn	वर्ण	वर्ण
varna	वर्णण	वर्ण
varnit	वर्णिि	वर्णित
vartamaan	वर्ततामान	वर्तमान
vartaman	वार्तमान	वर्तमान
vartmaan	वर््तमाा	वर्तमान
vartman	वा््तममन	वर्तमान
varddhaman	वर्धधमान	वर्द्धमान
vardhmaan	वर्धमान	वर्द्धमान
vardhman	वर्धमान	वर्द्धमान
verbal	वरबबल	वर्बल
varshan	वर्षन	वर्शन
vasharan	वश्रणण	वर्शन
vershan	वर्शन	वर्शन
version	वर्जिन	वर्शन
varsaache	वर्साचे	वर्साचे
varsaryache	वार्यस्रची	वर्साचे
vasearche	वासररच	वर्साचे
valkan	वाल्कन	वल्कन
valkkan	वाल्ककन	वल्कन
velkan	वेल्कन	वल्कन
vash	वाष	वश
vashikaran	वाष्षीकरण	वशीकरण
vaangchuk	वांगुकुक	वांगचुक
vangchuk	वंंलुकक	वांगचुक
wangchuk	वंंलुकक	वांगचुक
want	वांट	वांट
vije	विजे	वाइज
vise	विसे	वाइज
wise	वास	वाइज
vatar	वातरर	वाटर
water	वेटर	वाटर
watson	वा्सों	वाटसन
wattson	वा्त्सों	वाटसन
vaan	वान	वाण
waan	वान	वाण
vaanon	वानों	वाणों
vanon	वानों	वाणों
wanon	वानों	वाणों
vatanukulan	वातानुकुलन	वातानुकूलन
watanukoollan	वातानुकुुलल	वातानुकूलन
vaadak	वादक	वादक
vadak	वादक	वादक
vaadiyon	वादियों	वादियों
vadiyon	वादियों	वादियों
wadiyon	वादियों	वादियों
vayana	वायना	वायना
vayna	वायना	वायना
wayna	वायना	वायना
wireless	वायरेलसस	वायरलेस
wirerless	वायररल्स	वायरलेस
warrior	वररियर	वारियर्स
warriors	वैरियरस	वारियर्स
valve	वालवे	वाल्व
wolv	वॉल्व	वाल्व
vastavik	वास्ताविक	वास्तविक
vastvik	वास्त्विक	वास्तविक
vaahikayen	वाहिकाएं	वाहिकाएं
vahikayen	वाहिकाएं	वाहिकाएं
wahikayan	वाहिकाएं	वाहिकाएं
winter	विंटर	विंटर
vincent	विंसेंट	विंसेंट
vikalpon	विकललपों	विकल्पों
wicket	विकेक	विकेट
vikramjeet	विक्रजमित	विक्रमजीत
vikramjit	विक्रजमित	विक्रमजीत
vichaarakon	विचारकों	विचारकों
vicharakon	विचारकों	विचारकों
vigyan	विज्ञान	विज्ञान
vigyaani	विग्ञानी	विज्ञानी
vigyani	विज्ञानी	विज्ञानी
vigyaanon	विज्ञानों	विज्ञानों
vigyanon	विज्ञानों	विज्ञानों
vitthal	वित्थल	विट्ठल
viththal	विथ्थल	विठ्ठल
vitthal	वित्थल	विठ्ठल
vitark	वितररक	वितर्क
vidhaaein	विधाएं	विद्याएं
vidyaayein	विद्याएं	विद्याएं
vidyaen	विद्याएं	विद्याएं
vidhaaon	विधाओं	विद्याओं
vidyaaon	विद्याओं	विद्याओं
vidyaon	विद्याओं	विद्याओं
vidhansabhaein	विधानसभाां	विधानसभाएं
vidhansabhaen	विधानसभाां	विधानसभाएं
vidhivat	विधिवत	विधिवत
vidhut	विद्युत	विधुत
vinasht	विनाष्ट	विनष्ट
vineet	विनीत	विनीत
vinit	विनित	विनीत
vipreetataa	विप्रीतता	विपरीतता
vipritata	विप्रितता	विपरीतता
vipra	विपरर	विप्रा
vipro	विपपोर	विप्रो
wipro	विपपोर	विप्रो
vibha	विभा	विभा
vibhajak	विभाजजक	विभाजक
vibhram	विभ्रमम	विभ्रम
vibhrm	विभर्म	विभ्रम
vibram	विबब्रम	विभ्रम
vimarsh	विमार्ष	विमर्श
vimarsho	विमार्शों	विमर्शों
vimarshon	विमार्शों	विमर्शों
virajati	विराजतत	विराजती
virechan	विरेचन	विरेचन
virodh	विरोद	विरोध
virodhabhasi	विरोधभासी	विरोधाभासी
virodhabhason	विरोधभासों	विरोधाभासों
vividh	विविध	विविध
vivekahin	विवेकाहीन	विवेकहीन
vivekheen	विवेखीन	विवेकहीन
visheshan	विशेषण	विशेषण
visheshanon	विशेषनों	विशेषणों
visheshaadhikaar	विशेषाधिकार	विशेषाधिकार
visheshadhikar	विशेषाधिकार	विशेषाधिकार
vishwasaniy	विश्वासनीय	विश्वसनीय
vishwasniiya	विश्वासनीय	विश्वसनीय
vishwasaniyata	विश्वासननयता	विश्वसनीयता
vishwasniiyataa	विश्वससनीिता	विश्वसनीयता
vishahin	विशाहीं	विषहीन
vishhin	विशिनी	विषहीन
vishanu	विषानु	विष्णु
vishnu	विष्नु	विष्णु
vlc	व्ल्क	वीएलसी
weeks	वीक्स	वीक्स
veerchand	वीर्चंद	वीरचंद
virchand	वीरचंद	वीरचंद
veeresh	वीरेष	वीरेश
viresh	वियरष	वीरेश
vritton	वृत्तों	वृत्तों
vruton	वृत्तों	वृत्तों
vrutton	वृत्तों	वृत्तों
venkataraman	वेंकटरमण	वेंकटरमन
venkatraman	वेंकटररमन	वेंकटरमन
ved	वेद	वेड
wade	वादे	वेड
wed	वेड	वेड
wedding	वेडडिंग	वेडिंग
vediyon	वेदियों	वेदियों
vedon	वेडों	वेदों
venezuela	वेनेजेलल	वेनेजुएला
veronica	वेरोनिका	वेरोनिका
veronika	वेरोनिका	वेरोनिका
weronika	वेरोनिका	वेरोनिका
velvet	वेलवेट्	वेलवेट
welwet	वेलवेट	वेलवेट
welder	वेल्डर	वेल्डर
weldor	वेल्डोर	वेल्डर
welding	वेल्डिंग	वेल्डिंग
wealth	वेल्ट	वेल्थ
vellur	वेल्रर	वेल्लूर
velur	वेल्र	वेल्लूर
vesh	वेष	वेश
wasting	वास्टिंग	वेस्टिंग
westing	वेस्टिंग	वेस्टिंग
wastinghouse	वास्टिंजजजज	वेस्टिंगहाउस
westinghouse	वेश्टांजजजस	वेस्टिंगहाउस
vaisley	वैसलले	वेस्ले
vesle	वेसले	वेस्ले
wesle	वेसलल	वेस्ले
vaigyaanik	वैग्ञननिक	वैज्ञानिक
vaigyanik	वैग्ञननिक	वैज्ञानिक
vegyanik	वेज्ञनिक	वैज्ञानिक
vaigyaanikta	वैज्यजनिकता	वैज्ञानिकता
vaigyanikata	वाग्यनीककता	वैज्ञानिकता
vaigyanikta	वैज्यननयकता	वैज्ञानिकता
vaitravati	वैत्रवतती	वैत्रवती
vaitrawati	वैत्रवतती	वैत्रवती
vaimanasy	वैमानसय	वैमनस्य
vaimanasya	वैमान्य	वैमनस्य
vaimanya	वैमान्य	वैमनस्य
very	वेरी	वैरी
vaisaakh	वैसाखख	वैशाख
vaishakh	वैशाख	वैशाख
vaishaakhi	वैशाखी	वैशाखी
vaishakhi	वैशाखी	वैशाखी
vaishnodevi	वैश्योदेवी	वैष्णोदेवी
vyaktigat	व्यक्तिगित	व्यक्तिगत
vyagr	व्याग्र	व्यग्र
vyagra	व्याग्र	व्यग्र
vyatit	व्यत्ति	व्यतीत
vytit	व्यतित	व्यतीत
vyabhichar	व्याभिकार	व्यभिचार
vyabhichari	व्याभिचारी	व्यभिचार
vyavadhan	व्यववाधन	व्यवधान
vyavdhan	व्ववधान	व्यवधान
vyavahargat	व्यवहारारत	व्यवहारगत
vyvhargat	व्व्यार्ात	व्यवहारगत
vyaghat	व्याघात	व्याघात
vyapak	व्यापक	व्यापक
vlad	व्लाड	व्लाद
wlaad	व्लाड	व्लाद
vladimir	व्लाीीमीरी	व्लादिमीर
shanghai	शंघााई	शंघाई
shatpath	शट्पत्	शतपथ
shanivar	शानिवर	शनिवार
shaniwar	शानिवर	शनिवार
shabana	शबाना	शबाना
shbana	शबाना	शबाना
shabdarth	शब्दर्थ	शब्दार्थ
shamadan	शममदनन	शमादान
shmadan	शमादनन	शमादान
shamitabh	काततताभ	शमिताभ
shamil	शामील	शमिल
shmil	श्मील	शमिल
sharabon	शराबों	शराबों
shrabon	शररबों	शराबों
shararat	शरारत	शरारत
shrart	श्रार्त	शरारत
sharmana	शर्मना	शर्माना
shaharwasiyon	शहरववस्योों	शहरवासियों
shahrvasiyon	शहरववसियों	शहरवासियों
shervasiyon	शेरववसियों	शहरवासियों
shahdara	शाहदरा	शहादरा
shaantikaal	शांतिकाल	शांतिकाल
shantikal	शांतिककल	शांतिकाल
shaao	शाओ	शाओ
shao	शाओ	शाओ
shaakir	शाकीर	शाकिर
shakir	शाकीर	शाकिर
shaakhaaen	शाखाएं	शाखाएं
shakhayan	शाकायां	शाखाएं
shakhayen	शाखाएं	शाखाएं
shayak	शायक	शायक
shaavakon	शावकों	शावकों
shavakon	शावकों	शावकों
shavkon	शावकों	शावकों
shaasaka	शासका	शासक
shasak	शासक	शासक
sasakon	सससकों	शासकों
shaasakon	शासकों	शासकों
shasakon	शासकों	शासकों
shipra	शिप्र	शिप्रा
shirke	शिरके	शिर्के
sheershakon	शीर्षकों	शीर्षकों
shirshakon	शिर्शकों	शीर्षकों
shirshkon	शीर्शकों	शीर्षकों
shujaat	शुजात	शुजात
shujat	शुजात	शुजात
shooting	शूटींगंं	शुटिंग
shutting	श्टुटिंग	शुटिंग
should	शूल््	शुड
shud	शुदू	शुड
shubhankar	शुभंनकर	शुभंकर
shumaali	शुमाली	शुमाली
shumali	शुमाली	शुमाली
shringaar	श्रृंगार	शृंगार
shringar	श्रृंगरर	शृंगार
shrungar	श्रुंगर	शृंगार
sheling	शेलिंग	शेलिंग
shelling	शेल्ंिंग	शेलिंग
shaili	शैलीली	शैली
shaly	शा्य	शैली
sheli	शेली	शैली
shaishav	शैशाव	शैशव
sean	सीन	शॉन
shaun	शौंं	शॉन
shawn	शानन	शॉन
short	शोर्ट	शोर्ट
sure	सुरे	श्योर
shrankhala	श्रृंखला	श्रंखला
shrankhalaa	श्रृंखला	श्रंखला
shrunkhla	शृंृखला	श्रंखला
shrankhalaaon	श्रृंखलाओं	श्रंखलाओं
shrinkhalaon	श्रृंखओओं	श्रंखलाओं
shrunkhlaon	शृरृंलओओं	श्रंखलाओं
shravani	श्रावनी	श्रावणी
shrikar	श्रीकरर	श्रीकर
shrikhand	श्रीखंं	श्रीखंड
shrimati	श्रीमती	श्रीमति
shriram	श्रीररम	श्रीराम
sriram	श्रीरमम	श्रीराम
shrotaon	श्रोत्ओंं	श्रोताओं
shat	श्त	षट्
sankhyaein	संख्याएएं	संख्याएं
sankhyaen	संख्यााएं	संख्याएं
sankhyayen	साख्ययाएं	संख्याएं
sanghanit	संघीिित	संघनित
sanghnit	संघीनित	संघनित
sanchayan	संचायन	संचयन
sanchar	संचार	संचार
sanchaari	संचारी	संचारी
sanchari	संचारी	संचारी
sanchalanon	संचलनों	संचालनों
sanchalnon	संचलनों	संचालनों
sanjay	संजा	संजय
sanjeevan	संजीवन	संजीवन
sanjivan	संजीवन	संजीवन
santati	संततत	संतति
sandarbh	संदर्भ	संदर्भ
sandarbha	संदरभभ	संदर्भ
sandrbh	संद्रभ	संदर्भ
sandarbhon	संदर्भों	संदर्भों
sandrbhon	संद्रभों	संदर्भों
sandali	संदली	संदली
sandli	संडडल	संदली
sandhan	संधन	संधान
samprati	संप्रति	संप्रति
samprti	संप्र्ति	संप्रति
samprabhu	संप्रभू	संप्रभु
samprbhu	संप्रभू	संप्रभु
samprabhuta	संप्रभूतत	संप्रभुता
samprbhuta	संप्रभुता	संप्रभुता
sambit	संबित	संबित
sambhalane	संभालने	संभालने
sambhalne	संभालने	संभालने
sambhrant	संभररंत	संभ्रांत
sanbharnt	संभरर्त	संभ्रांत
sanyog	संयोगो	संयुक्त
sanyukt	सानुयककत	संयुक्त
sanyukta	सानुयककत	संयुक्त
sanyukta	सानुयककत	संयुक्ता
sanyogvash	संन्याव्श	संयोगवश
sanyojan	संयोजन	संयोजन
sanyojanon	संययजनोों	संयोजनों
sanyojnon	संययजनोों	संयोजनों
samvedikaran	संवेदेकरण	संवेदीकरण
sanvedikaran	संवेदीकरण	संवेदीकरण
samshayon	सम्ययों	संशयों
sanshayon	संशायों	संशयों
sanshyon	संश्यों	संशयों
sanskaar	संस्कार	संस्कार
sanskar	संस्कर	संस्कार
sanskaari	संस्कारी	संस्कारी
sanskari	संस्कारी	संस्कारी
sanskrit	संस्कृत	संस्कृत
sanskurt	संस्कृृत	संस्कृत
sanskritiyan	संस्कृतियां	संस्कृतियां
sanskrutiyan	संस्कृतियां	संस्कृतियां
sanskritiyon	संस्कृतियों	संस्कृतियों
sanskrutiyon	संस्कृतियों	संस्कृतियों
sanasthit	संस्थिति	संस्थित
sansthit	संस्थित	संस्थित
sanasthita	सास्थथित	संस्थिता
sansthita	संस्थितत	संस्थिता
sakara	सकरा	सकरा
sakra	सकरा	सकरा
sakshan	साक्षण	सक्शन
suction	सक्क्शन	सक्शन
sacchidanand	सचीचिदानंद	सच्चिदानंद
sachhidanand	सचीचिदानं	सच्चिदानंद
sachidanand	सचीदानंंं	सच्चिदानंद
sajja	सजजज	सज्जा
sat	सतत	सत
satpal	सत्पाल	सतपाल
satluj	सतलुजज	सतलुज
sataane	सताने	सताने
satane	सततने	सताने
sate	साते	सते
satti	सत्ती	सत्ती
satvat	सत्वात	सत्वत
sadanand	सद्नांद	सदानंद
sapane	सपनने	सपने
sapne	सपने	सपने
sapney	सपने	सपने
saparivaar	सपरिवारर	सपरिवार
sapariwar	सरिवावार	सपरिवार
sparivar	स्पिरवार	सपरिवार
sapaat	सपात	सपाट
sapat	सपात	सपाट
sapate	सपतते	सपाटे
sapatey	सपतते	सपाटे
saptakranti	सत्तक्रणति	सप्तक्रांति
saptkraanti	सप्तककरणती	सप्तक्रांति
saptapadi	सप्तापदी	सप्तपदी
saptpadi	सप्तावदी	सप्तपदी
saptari	सप्तारी	सप्तरी
sapramaan	सप्रमाण	सप्रमाण
sapraman	सप्रमाण	सप्रमाण
submit	सब्मिट	सबमिट
sabmission	साब्िसनस	सबमिशन
submission	सब्जिसन	सबमिशन
sabhaein	सभाएएं	सभाएं
sabhaen	सभाएं	सभाएं
sabhayen	सभाएं	सभाएं
sabhen	सभें	सभाएं
sabhasadon	सभासाोों	सभासदों
sabhyata	सभ्यता	सभ्यता
samjhoonga	समझुगा	समझूंगा
samjhunga	समझुगा	समझूंगा
samjhungaa	समझंगा	समझूंगा
saman	सामान	समन
samanvayaka	समनववयका	समन्वयक
samanwayaka	समनववयका	समन्वयक
samnvyak	समन्वयक	समन्वयक
samaadhaan	समाधान	समाधान
samadhan	समाधनन	समाधान
samadhiyon	समाधियों	समाधियों
samadjiyon	समाज्यियों	समाधियों
samalakha	समललखा	समालखा
samalakhaa	समालखा	समालखा
samahaar	समाहार	समाहार
samahar	समारा	समाहार
samitiyan	समीतियां	समितियां
sametati	समेटती	समेटती
sametti	समेट्टी	समेटती
sarka	सर्का	सरका
sarkaa	सरका	सरका
sarkarein	सरकारें	सरकारें
sarkaren	सरकारें	सरकारें
sarkaaron	सरकारों	सरकारों
sarkaron	सरकारों	सरकारों
sargana	सर्गना	सरगना
sarganaon	सर्गनाओं	सरगनाओं
sargi	सर्गी	सरगी
sarguja	सर्गुज	सरगुजा
sarjuga	सारुजा	सरगुजा
sarsa	सरसा	सरसा
sarsaa	सरसा	सरसा
sarahind	साहीिंद	सरहिंद
sarhind	सरीींद	सरहिंद
sirhind	सीरींंद	सरहिंद
saraaha	सराहा	सराहा
saraha	सराह	सराहा
saraahi	सराही	सराही
sarahi	सराही	सराही
salaahkar	सलाहकर	सलाहकार
salahkaar	सलाहाकार	सलाहकार
salahkar	सलाहकर	सलाहकार
saleeb	सलीली	सलीब
salib	सलीबब	सलीब
select	सेलेक्ट	सलेक्ट
saltanat	सल््टाटत	सल्तनत
saltnat	सल््नाटत	सल्तनत
savaal	सवाल	सवाल
saval	सावल	सवाल
sawaal	सवाल	सवाल
sawal	सावल	सवाल
sahakalaakar	सहकालकर	सहकलाकार
sahakalakar	सहकालकर	सहकलाकार
sahkalakar	सहकालकर	सहकलाकार
sahadev	सहदेवे	सहदेव
sahdev	सहदेव	सहदेव
sahrawat	सहरावत	सहरावत
sherawat	शेरावत	सहरावत
sahooliyata	सहूलियता	सहूलियत
sahuliyat	सहुलियत	सहूलियत
sahuuliyata	सहूलियता	सहूलियत
saanketika	सांक्तिका	सांकेतिक
sanketik	सांकेतिक	सांकेतिक
saimans	सैमानस	साइमंस
simmons	सिममंस	साइमंस
symons	सायमोस	साइमंस
saima	सैमम	साइमा
sagarika	सगररिका	सागरिका
sagrika	सगरीिका	सागरिका
saga	सागा	सागा
saajan	साजन	साजन
sajan	सजनन	साजन
saajsajja	साजसजजज	साजसज्जा
sajsajja	साजसजज	साजसज्जा
saja	सजज	साजा
saathsaath	साथसथाथ	साथसाथ
sathsath	साथसथा	साथसाथ
sathiya	सथथयय	साथिया
saabah	साबाह	साबाह
sabah	सबाह	साबाह
samanjasy	समंजास्य	सामंजस्य
samanjasya	समंजास्य	सामंजस्य
samoa	समो	सामोआ
samoaa	समोआा	सामोआ
saayn	सायन	सायं
sayan	सययन	सायं
saym	सायम	सायं
saira	सैरा	सायरा
sayara	सायरा	सायरा
sayra	सायरा	सायरा
salve	सललवे	साल्वे
sahab	सहाब	साहब
singapore	सिंगपपपरर	सिंगापुर
singaar	सिंगार	सिंगार
singar	सिंगर	सिंगार
singer	सिंगर	सिंगार
singhaadey	सिंहाड़े	सिंघाड़े
singhade	सिंहदे	सिंघाड़े
singhde	सिंहदे	सिंघाड़े
singhre	सिंहरे	सिंघाड़े
singhi	सिंही	सिंघी
singha	सिंहा	सिंहा
sinha	सिन्हा	सिंहा
siera	सियरा	सिएरा
sierra	सिररा	सिएरा
sikud	सिकुड़	सिकुड़
signals	सिगनाल्स	सिगनल्स
cigaretton	सागगर्टोट	सिगरेटों
cigretton	सागग्रेटन	सिगरेटों
siddhivat	सिद्धिवत	सिद्धवट
siddhvat	सिद्धववत	सिद्धवट
siddhwat	सिद्धववत	सिद्धवट
sinabang	सिनाबंं	सिनाबंग
synapse	सियनपसस	सिनेप्स
sipah	सिपाह	सिपाह
sipaha	सिपाहा	सिपाह
sipahiyon	सिपाहियों	सिपाहियों
sipahi	सिपाही	सिपाही
sim	सिम	सिम
simat	सीमत	सिमट
simatataa	सीमटता	सिमटता
simatta	सीमात्	सिमटता
simtata	सिमटता	सिमटता
simtataa	सिम्तता	सिमटता
cement	सीमेंट	सिमटे
simate	सिमतेे	सिमटे
simi	सीमी	सिमी
simmy	सिम्म	सिमी
sims	सिम्स	सिम्स
siyasi	सियासी	सियासी
siyah	सियाह	सियाह
siyaha	सियाहा	सियाह
sirpur	सिरपुर	सिरपुर
sivan	सिवान	सिवान
siwan	सिवान	सिवान
sisva	सिस्वा	सिसवा
siswa	सिस्वा	सिसवा
cil	सिल्	सीआईएल
csi	सीसी	सीएसआई
sikar	सिकार	सीकर
seaten	सीटेन	सीटें
sitaram	सीतारम	सीताराम
sitaharan	सिताराण	सीताहरण
cpm	साप्म	सीपीएम
cps	सीप्स	सीपीएस
cbse	क्लेस	सीबीएसई
seem	सीम	सीम
sim	सिम	सीम
sealed	सीलेड	सील्ड
shield	शील्ड	सील्ड
ccd	कीक्ड	सीसीडी
sugamata	सुगमता	सुगमता
sugmta	सुग्ात	सुगमता
sujan	सुजन	सुजेन
sujen	सुजें	सुजेन
suken	सुकेन	सुजेन
sujain	सुजाइं	सुजैन
sujhaati	सुझाती	सुझाती
sujhati	सुझती	सुझाती
sutali	सुतली	सुतली
sutli	सुतली	सुतली
suta	सूता	सुता
sdueep	स्दूपी	सुदीप
sudip	सुदीप	सुदीप
sudhaargrah	सुधारग्रह	सुधारगृह
sudhargrih	सुध्रगृरी	सुधारगृह
sudhargruh	सुध्रगृरु	सुधारगृह
sunaaron	सुनारों	सुनारों
sunaron	सुनारों	सुनारों
sunaseer	सुनसीीर	सुनासीर
sunasir	सुनासीर	सुनासीर
suneeti	सुनीती	सुनीति
suniti	सुनीती	सुनीति
sunega	सुनेगा	सुनेगा
suneyga	सुनेगा	सुनेगा
superhit	सुपररहित	सुपरहिट
supachy	सुपाचय	सुपाच्य
supachya	सुपाच्य	सुपाच्य
supachye	सुपाचय	सुपाच्य
subhaay	सुभाय	सुभाय
subhay	सुभाय	सुभाय
surveen	सुर्वीन	सुरवीन
survin	सुर्विन	सुरवीन
surana	सुरना	सुराणा
sulkhan	सुल्खन	सुलखान
suljaayi	सुलजायी	सुलझाई
suljayi	सुलजाई	सुलझाई
suljhai	सुलझाई	सुलझाई
sulzai	सुलझाई	सुलझाई
sultana	सुल्टाना	सुलताना
sulaati	सुलाती	सुलाती
sulati	सुलतत	सुलाती
susanskrit	सुसससकृृतत	सुसंस्कृत
susanskrut	सुसससकृृत	सुसंस्कृत
suhagin	सुहागीन	सुहागिन
soond	सूंड	सूंड़
sund	सुंड	सूंड़
suiyan	सुययां	सूइयां
sukhati	सूखती	सूखती
sukhti	सूखती	सूखती
sukhakar	सुखाकर	सूखाकर
soochak	सूचक	सूचक
suchak	सुचाक	सूचक
sooja	सूजा	सूजा
suja	सुजा	सूजा
suba	सुबा	सूबा
sube	सुबे	सूबे
sooraj	सूराज	सूरज
suraj	सुरजा	सूरज
surinaam	सुरीणाम	सूरीनाम
surinama	सुरीनामा	सूरीनाम
suriname	सुरीनेम	सूरीनाम
suryadev	सुर्यदेव	सूर्यदेव
sendha	सेंधा	सेंधा
senvai	सेनवाई	सेंवई
sevai	सेवाई	सेंवई
sensing	सेंसिंग	सेंसिंग
sexual	सेक्सिलल	सेक्सुअल
saturday	सतुर्दा	सेटरडे
seti	सेती	सेटी
seto	सेटो	सेटो
seth	सेथ	सेथ
safety	सैफेटी	सेफ्टी
semen	सीमेन	सेमिन
semin	सेमिन	सेमिन
self	सेल्फ	सेल्फ
selfie	सेल्फी	सेल्फी
save	साव	सेव
sev	सेव	सेव
sevakon	सेवकों	सेवकों
sevkon	सेवकों	सेवकों
samuels	सैमुल्स	सैम्युल्स
celery	सेलेरी	सैलरी
salary	सालारी	सैलरी
sakar	साकार	सॉकर
socar	सोकर	सॉकर
soccer	सॉस्सर	सॉकर
songs	सोंग्स	सॉन्ग्स
solicitor	सॉलिसिटर	सॉलिसिटर
sochane	सोचने	सोचने
sochne	सोचने	सोचने
sonu	सोनो	सोनू
soma	सोमा	सोमा
spma	स्पामम	सोमा
somi	सोमी	सोमी
soy	सोय	सोय
soya	सोया	सोया
solitaire	सोलिटेइर	सोलिटेयर
soharai	सोहराई	सोहराई
sohrai	सोहराई	सोहराई
sohaval	सोहवाल	सोहावल
sohawal	सोहवाल	सोहावल
saunpane	सौंपने	सौंपने
sonpne	सोंपने	सौंपने
scala	स्काला	स्काला
skala	स्काा	स्काला
ski	स्कीरी	स्की
scootaron	स्क्टररों	स्कूटरों
scooteron	स्क्टेरों	स्कूटरों
skootaron	स्कूतरों	स्कूटरों
scandinavia	स्कैंडानियाय	स्कैंडिनेविया
scaining	स्केनिंग	स्कैनिंग
scanning	स्कैनिनि	स्कैनिंग
squash	स्क्वाश	स्क्वाश
squash	स्क्वाश	स्क्वैश
skhalan	स्खलन	स्खलन
stain	स्टेन	स्टैन
stan	स्तान	स्टैन
stop	स्टोपो	स्टॉप
stops	स्टोप्स	स्टॉप्स
stone	स्टोनो	स्टोन
straws	स्ट्रास	स्ट्रास
stress	स्ट्रेस	स्ट्रास
stra	स्त्रा	स्ट्रे
stray	स्त्राय	स्ट्रे
stre	स्ट्रे	स्ट्रे
strocks	स्ट्रॉक्स	स्ट्रोक्स
strokes	स्ट्रॉकेस	स्ट्रोक्स
stan	स्तान	स्तन
stanadhari	स्तनधारी	स्तनधारी
standhaari	स्तंधारी	स्तनधारी
standhari	स्तंधारी	स्तनधारी
sthiti	स्थिति	स्तिथि
stithi	स्तीथि	स्तिथि
stuti	स्तूटी	स्तुति
sthitiyaan	स्थीतियां	स्थितियां
sthitiyan	स्थीतियां	स्थितियां
sthitiyon	स्थीतियों	स्थितियों
sthool	स्थूल	स्थूल
sthul	स्थुल	स्थूल
sthoolta	स्थुलता	स्थूलता
sthulata	स्थुलता	स्थूलता
sneakers	स्नेकक्स	स्नीकर्स
snickers	स्नेकर्स	स्नीकर्स
snikarse	स्नीकर्स	स्नीकर्स
spear	स्पीयर	स्पीयर
spell	स्पेल	स्पेल
spelar	स्पेलर	स्पेलर
speller	स्पेलर	स्पेलर
sprint	स्प्रिंत	स्प्रिट
sprit	स्प्रित	स्प्रिट
spray	स्प्राय	स्प्रे
spry	स्प्र्य	स्प्रे
sfoorti	स्फूर्ती	स्फूर्ति
sfurti	स्फूर्टी	स्फूर्ति
sphoorti	स्थूर्ती	स्फूर्ति
slide	स्लाइड	स्लाइड
slider	स्लाइडर	स्लाइडर
slaaidon	स्लाडोंं	स्लाइडों
slidon	स्लिडों	स्लाइडों
sliders	स्लाइडर्स	स्लाइड्स
slides	स्लाइडेस	स्लाइड्स
slice	स्लाइस	स्लाइस
slash	स्लाष	स्लैश
swaroopon	स्वरूपों	स्वरुपों
swarupon	स्वरूपों	स्वरुपों
swa	स्वा	स्वा
swaachaalit	स्वचालित	स्वाचालित
swachalit	स्वचालित	स्वाचालित
swaarthparak	स्वार्थपरकक	स्वार्थपरक
swarthparak	स्वर्थार्ाक	स्वार्थपरक
swiftlate	स्विफ्लेटट	स्विफ्टलेट
swiftlet	स्विफलालेट	स्विफ्टलेट
sweekarte	स्वीकारत	स्वीकारते
swikarte	स्वीकारत	स्वीकारते
sweet	स्वीत	स्वीट
sweep	स्वीप	स्वीप
sweccha	स्वेच्छा	स्वेच्छा
swecha	स्वेच्छा	स्वेच्छा
swechha	स्वेच्छा	स्वेच्छा
sweta	स्वेता	स्वेता
swap	स्वप्प	स्वैप
swipe	स्विप	स्वैप
handiya	हैंडिया	हंडिया
handiyaa	हैंडिया	हंडिया
hundiya	हुंडिया	हंडिया
hakikat	हाकिकत	हकीकत
haqeeqat	हकीकत	हकीकत
hathiya	हाथिया	हथिया
hamala	हमाला	हमला
hamla	हमाला	हमला
hamalavar	हमालावर	हमलावर
hamlavar	हमलावार	हमलावर
humlavar	हममावार	हमलावर
hamaal	हमाल	हमाल
hamal	हमाल	हमाल
hercules	हर्कुल्स	हरक्यूलिस
hardas	हरददास	हरदास
harpaal	हरपाल	हरपाल
harpal	हरपाल	हरपाल
harvansh	हर्वंं	हरवंश
haraval	हरावलल	हरावल
harawal	हरावलल	हरावल
hurricane	ह्रिरिकन	हरिकेन
harijan	हरिजन	हरिजन
hariyali	हरियाली	हरियाली
harshit	हर्शित	हर्षित
haldi	हल्दी	हल्दी
halla	हललला	हल्ला
hawamahal	हवामाह	हवामहल
hawalaat	हवालात	हवालात
hawalat	हवालत	हवालात
hasino	हससननों	हसीनों
hasinon	हसीनों	हसीनों
haan	हान	हां
han	हान	हां
haanfte	हैंफते	हांफते
hafate	हफफते	हांफते
hanfte	हैंफ़े	हांफते
higman	हिगममन	हाइमन
hymen	हाइमेन	हाइमन
hadauti	हड़ती	हाड़ौती
haani	हानी	हानी
hani	हानी	हानी
haarjeet	हरजीत	हारजीत
harjeet	हरजीत	हारजीत
haaranaa	हारना	हारना
harana	हराना	हारना
harna	हरनन	हारना
haalchaal	हालचाल	हालचाल
haalchal	हालचाल	हालचाल
halchaal	हल्चाल	हालचाल
halchal	हल्चाल	हालचाल
halt	हाल्ट	हाल्ट
hault	हॉलल्ट	हाल्ट
hahakar	हाहार	हाहाकार
hingis	हिंगिस	हिंगिस
hindan	हिंदनन	हिंडन
hindon	हिंदों	हिंडन
hijada	हिजड़ा	हिजड़ा
hijda	हिज़ा	हिजड़ा
hijbul	हिजबूल	हिजबुल
hippo	हिप्पोप	हिप्पो
hippopotamus	हिपपपोप्मेसम	हिप्पोपोटेमस
himali	हिमाली	हिमाली
hilane	हिलने	हिलने
hilne	हिलने	हिलने
hisham	हिश्म	हिशाम
heeraganj	हीरागंंज	हीरागंज
hiraganj	हिरागंज	हीरागंज
heroes	हेरोजस	हीरोज
heros	हेरोस	हीरोज
hui	हुई	हुईं
huin	हुईन	हुईं
hooper	हूपपर	हूपर
huppar	हुपपर	हूपर
hupper	हुपपरर	हूपर
hegde	हेगडे	हेगडे
hemvati	हेमवाती	हेमवती
hemwati	हेमवाती	हेमवती
help	हेल्प्प	हेल्प
helper	हेल्पर	हेल्पर
haito	हैतों	हैतो
hairam	हैराम	हैरम
harem	हरेमम	हैरम
herald	हेराल्ड	हैराल्ड
haive	हैववे	हैव
have	हावे	हैव
hong	हांगो	हॉन्ग
half	हैफ्	हॉफ
hoaf	हाफफ	हॉफ
hounga	हाउगग	होऊंगा
holding	हॉल्डिंग	होल्डिंग
hoshangabaad	होशंबाबाद	होशंगाबाद
hoshangabad	होशंबाबाद	होशंगाबाद
hostes	होस्टेस	होस्टेस
hostess	होस्टेस	होस्टेस
